State,Level,Name,TRU,TOT_P,TOT_M,TOT_F
00,India,India,Total,1210854977,623270258,587584719
00,India,India,Rural,833748852,427781058,405967794
00,India,India,Urban,377106125,195489200,181616925
01,STATE,JAMMU & KASHMIR,Total,12541302,6640662,5900640
01,STATE,JAMMU & KASHMIR,Rural,9108060,4774477,4333583
01,STATE,JAMMU & KASHMIR,Urban,3433242,1866185,1567057
01,DISTRICT,Kupwara,Total,870354,474190,396164
01,DISTRICT,Kupwara,Rural,765625,412038,353587
01,DISTRICT,Kupwara,Urban,104729,62152,42577
01,DISTRICT,Badgam,Total,753745,398041,355704
01,DISTRICT,Badgam,Rural,655833,343385,312448
01,DISTRICT,Badgam,Urban,97912,54656,43256
01,DISTRICT,Leh(Ladakh),Total,133487,78971,54516
01,DISTRICT,Leh(Ladakh),Rural,87816,48411,39405
01,DISTRICT,Leh(Ladakh),Urban,45671,30560,15111
01,DISTRICT,Kargil,Total,140802,77785,63017
01,DISTRICT,Kargil,Rural,124464,67703,56761
01,DISTRICT,Kargil,Urban,16338,10082,6256
01,DISTRICT,Punch,Total,476835,251899,224936
01,DISTRICT,Punch,Rural,438205,229774,208431
01,DISTRICT,Punch,Urban,38630,22125,16505
01,DISTRICT,Rajouri,Total,642415,345351,297064
01,DISTRICT,Rajouri,Rural,590101,310748,279353
01,DISTRICT,Rajouri,Urban,52314,34603,17711
01,DISTRICT,Kathua,Total,616435,326109,290326
01,DISTRICT,Kathua,Rural,526722,278126,248596
01,DISTRICT,Kathua,Urban,89713,47983,41730
01,DISTRICT,Baramula,Total,1008039,534733,473306
01,DISTRICT,Baramula,Rural,825539,432399,393140
01,DISTRICT,Baramula,Urban,182500,102334,80166
01,DISTRICT,Bandipore,Total,392232,207680,184552
01,DISTRICT,Bandipore,Rural,326871,172263,154608
01,DISTRICT,Bandipore,Urban,65361,35417,29944
01,DISTRICT,Srinagar,Total,1236829,651124,585705
01,DISTRICT,Srinagar,Rural,17313,8916,8397
01,DISTRICT,Srinagar,Urban,1219516,642208,577308
01,DISTRICT,Ganderbal,Total,297446,158720,138726
01,DISTRICT,Ganderbal,Rural,250407,133715,116692
01,DISTRICT,Ganderbal,Urban,47039,25005,22034
01,DISTRICT,Pulwama,Total,560440,293064,267376
01,DISTRICT,Pulwama,Rural,479978,248096,231882
01,DISTRICT,Pulwama,Urban,80462,44968,35494
01,DISTRICT,Shupiyan,Total,266215,136480,129735
01,DISTRICT,Shupiyan,Rural,249855,127161,122694
01,DISTRICT,Shupiyan,Urban,16360,9319,7041
01,DISTRICT,Anantnag,Total,1078692,559767,518925
01,DISTRICT,Anantnag,Rural,795805,411012,384793
01,DISTRICT,Anantnag,Urban,282887,148755,134132
01,DISTRICT,Kulgam,Total,424483,217620,206863
01,DISTRICT,Kulgam,Rural,343870,175574,168296
01,DISTRICT,Kulgam,Urban,80613,42046,38567
01,DISTRICT,Doda,Total,409936,213641,196295
01,DISTRICT,Doda,Rural,377247,195430,181817
01,DISTRICT,Doda,Urban,32689,18211,14478
01,DISTRICT,Ramban,Total,283713,149132,134581
01,DISTRICT,Ramban,Rural,271902,142317,129585
01,DISTRICT,Ramban,Urban,11811,6815,4996
01,DISTRICT,Kishtwar,Total,230696,120165,110531
01,DISTRICT,Kishtwar,Rural,215831,111986,103845
01,DISTRICT,Kishtwar,Urban,14865,8179,6686
01,DISTRICT,Udhampur,Total,554985,296784,258201
01,DISTRICT,Udhampur,Rural,446777,232974,213803
01,DISTRICT,Udhampur,Urban,108208,63810,44398
01,DISTRICT,Reasi,Total,314667,166461,148206
01,DISTRICT,Reasi,Rural,287671,151481,136190
01,DISTRICT,Reasi,Urban,26996,14980,12016
01,DISTRICT,Jammu,Total,1529958,813821,716137
01,DISTRICT,Jammu,Rural,764945,401603,363342
01,DISTRICT,Jammu,Urban,765013,412218,352795
01,DISTRICT,Samba,Total,318898,169124,149774
01,DISTRICT,Samba,Rural,265283,139365,125918
01,DISTRICT,Samba,Urban,53615,29759,23856
02,STATE,HIMACHAL PRADESH,Total,6864602,3481873,3382729
02,STATE,HIMACHAL PRADESH,Rural,6176050,3110345,3065705
02,STATE,HIMACHAL PRADESH,Urban,688552,371528,317024
02,DISTRICT,Chamba,Total,519080,261320,257760
02,DISTRICT,Chamba,Rural,482972,241963,241009
02,DISTRICT,Chamba,Urban,36108,19357,16751
02,DISTRICT,Kangra,Total,1510075,750591,759484
02,DISTRICT,Kangra,Rural,1423794,705365,718429
02,DISTRICT,Kangra,Urban,86281,45226,41055
02,DISTRICT,Lahul & Spiti,Total,31564,16588,14976
02,DISTRICT,Lahul & Spiti,Rural,31564,16588,14976
02,DISTRICT,Lahul & Spiti,Urban,0,0,0
02,DISTRICT,Kullu,Total,437903,225452,212451
02,DISTRICT,Kullu,Rural,396512,203269,193243
02,DISTRICT,Kullu,Urban,41391,22183,19208
02,DISTRICT,Mandi,Total,999777,498065,501712
02,DISTRICT,Mandi,Rural,937140,466050,471090
02,DISTRICT,Mandi,Urban,62637,32015,30622
02,DISTRICT,Hamirpur,Total,454768,217070,237698
02,DISTRICT,Hamirpur,Rural,423338,200748,222590
02,DISTRICT,Hamirpur,Urban,31430,16322,15108
02,DISTRICT,Una,Total,521173,263692,257481
02,DISTRICT,Una,Rural,476260,240254,236006
02,DISTRICT,Una,Urban,44913,23438,21475
02,DISTRICT,Bilaspur,Total,381956,192764,189192
02,DISTRICT,Bilaspur,Rural,356827,179653,177174
02,DISTRICT,Bilaspur,Urban,25129,13111,12018
02,DISTRICT,Solan,Total,580320,308754,271566
02,DISTRICT,Solan,Rural,478173,249736,228437
02,DISTRICT,Solan,Urban,102147,59018,43129
02,DISTRICT,Sirmaur,Total,529855,276289,253566
02,DISTRICT,Sirmaur,Rural,472690,246175,226515
02,DISTRICT,Sirmaur,Urban,57165,30114,27051
02,DISTRICT,Shimla,Total,814010,425039,388971
02,DISTRICT,Shimla,Rural,612659,314295,298364
02,DISTRICT,Shimla,Urban,201351,110744,90607
02,DISTRICT,Kinnaur,Total,84121,46249,37872
02,DISTRICT,Kinnaur,Rural,84121,46249,37872
02,DISTRICT,Kinnaur,Urban,0,0,0
03,STATE,PUNJAB,Total,27743338,14639465,13103873
03,STATE,PUNJAB,Rural,17344192,9093476,8250716
03,STATE,PUNJAB,Urban,10399146,5545989,4853157
03,DISTRICT,Gurdaspur,Total,2298323,1212617,1085706
03,DISTRICT,Gurdaspur,Rural,1639004,855784,783220
03,DISTRICT,Gurdaspur,Urban,659319,356833,302486
03,DISTRICT,Kapurthala ,Total,815168,426311,388857
03,DISTRICT,Kapurthala ,Rural,532706,275932,256774
03,DISTRICT,Kapurthala ,Urban,282462,150379,132083
03,DISTRICT,Jalandhar,Total,2193590,1145211,1048379
03,DISTRICT,Jalandhar,Rural,1032419,528790,503629
03,DISTRICT,Jalandhar,Urban,1161171,616421,544750
03,DISTRICT,Hoshiarpur,Total,1586625,809057,777568
03,DISTRICT,Hoshiarpur,Rural,1251656,634470,617186
03,DISTRICT,Hoshiarpur,Urban,334969,174587,160382
03,DISTRICT,Shahid Bhagat Singh Nagar ,Total,612310,313291,299019
03,DISTRICT,Shahid Bhagat Singh Nagar ,Rural,486894,248118,238776
03,DISTRICT,Shahid Bhagat Singh Nagar ,Urban,125416,65173,60243
03,DISTRICT,Fatehgarh Sahib,Total,600163,320795,279368
03,DISTRICT,Fatehgarh Sahib,Rural,414681,220050,194631
03,DISTRICT,Fatehgarh Sahib,Urban,185482,100745,84737
03,DISTRICT,Ludhiana,Total,3498739,1867816,1630923
03,DISTRICT,Ludhiana,Rural,1429031,753444,675587
03,DISTRICT,Ludhiana,Urban,2069708,1114372,955336
03,DISTRICT,Moga,Total,995746,525920,469826
03,DISTRICT,Moga,Rural,768500,405704,362796
03,DISTRICT,Moga,Urban,227246,120216,107030
03,DISTRICT,Firozpur,Total,2029074,1071637,957437
03,DISTRICT,Firozpur,Rural,1476518,776208,700310
03,DISTRICT,Firozpur,Urban,552556,295429,257127
03,DISTRICT,Muktsar,Total,901896,475622,426274
03,DISTRICT,Muktsar,Rural,649705,342202,307503
03,DISTRICT,Muktsar,Urban,252191,133420,118771
03,DISTRICT,Faridkot,Total,617508,326671,290837
03,DISTRICT,Faridkot,Rural,400457,210782,189675
03,DISTRICT,Faridkot,Urban,217051,115889,101162
03,DISTRICT,Bathinda,Total,1388525,743197,645328
03,DISTRICT,Bathinda,Rural,889308,474484,414824
03,DISTRICT,Bathinda,Urban,499217,268713,230504
03,DISTRICT,Mansa,Total,769751,408732,361019
03,DISTRICT,Mansa,Rural,606147,322184,283963
03,DISTRICT,Mansa,Urban,163604,86548,77056
03,DISTRICT,Patiala,Total,1895686,1002522,893164
03,DISTRICT,Patiala,Rural,1132406,598800,533606
03,DISTRICT,Patiala,Urban,763280,403722,359558
03,DISTRICT,Amritsar ,Total,2490656,1318408,1172248
03,DISTRICT,Amritsar ,Rural,1156045,607266,548779
03,DISTRICT,Amritsar ,Urban,1334611,711142,623469
03,DISTRICT,Tarn Taran,Total,1119627,589369,530258
03,DISTRICT,Tarn Taran,Rural,977832,514322,463510
03,DISTRICT,Tarn Taran,Urban,141795,75047,66748
03,DISTRICT,Rupnagar,Total,684627,357485,327142
03,DISTRICT,Rupnagar,Rural,506820,264089,242731
03,DISTRICT,Rupnagar,Urban,177807,93396,84411
03,DISTRICT,Sahibzada Ajit Singh Nagar,Total,994628,529253,465375
03,DISTRICT,Sahibzada Ajit Singh Nagar,Rural,450017,240984,209033
03,DISTRICT,Sahibzada Ajit Singh Nagar,Urban,544611,288269,256342
03,DISTRICT,Sangrur,Total,1655169,878029,777140
03,DISTRICT,Sangrur,Rural,1139204,604653,534551
03,DISTRICT,Sangrur,Urban,515965,273376,242589
03,DISTRICT,Barnala,Total,595527,317522,278005
03,DISTRICT,Barnala,Rural,404842,215210,189632
03,DISTRICT,Barnala,Urban,190685,102312,88373
04,STATE,CHANDIGARH,Total,1055450,580663,474787
04,STATE,CHANDIGARH,Rural,28991,17150,11841
04,STATE,CHANDIGARH,Urban,1026459,563513,462946
04,DISTRICT,Chandigarh,Total,1055450,580663,474787
04,DISTRICT,Chandigarh,Rural,28991,17150,11841
04,DISTRICT,Chandigarh,Urban,1026459,563513,462946
05,STATE,UTTARAKHAND,Total,10086292,5137773,4948519
05,STATE,UTTARAKHAND,Rural,7036954,3519042,3517912
05,STATE,UTTARAKHAND,Urban,3049338,1618731,1430607
05,DISTRICT,Uttarkashi,Total,330086,168597,161489
05,DISTRICT,Uttarkashi,Rural,305781,155375,150406
05,DISTRICT,Uttarkashi,Urban,24305,13222,11083
05,DISTRICT,Chamoli,Total,391605,193991,197614
05,DISTRICT,Chamoli,Rural,332209,160369,171840
05,DISTRICT,Chamoli,Urban,59396,33622,25774
05,DISTRICT,Rudraprayag,Total,242285,114589,127696
05,DISTRICT,Rudraprayag,Rural,232360,108740,123620
05,DISTRICT,Rudraprayag,Urban,9925,5849,4076
05,DISTRICT,Tehri Garhwal,Total,618931,297986,320945
05,DISTRICT,Tehri Garhwal,Rural,548792,259381,289411
05,DISTRICT,Tehri Garhwal,Urban,70139,38605,31534
05,DISTRICT,Dehradun,Total,1696694,892199,804495
05,DISTRICT,Dehradun,Rural,754753,392891,361862
05,DISTRICT,Dehradun,Urban,941941,499308,442633
05,DISTRICT,Garhwal,Total,687271,326829,360442
05,DISTRICT,Garhwal,Rural,574568,268029,306539
05,DISTRICT,Garhwal,Urban,112703,58800,53903
05,DISTRICT,Pithoragarh,Total,483439,239306,244133
05,DISTRICT,Pithoragarh,Rural,413834,202930,210904
05,DISTRICT,Pithoragarh,Urban,69605,36376,33229
05,DISTRICT,Bageshwar,Total,259898,124326,135572
05,DISTRICT,Bageshwar,Rural,250819,119615,131204
05,DISTRICT,Bageshwar,Urban,9079,4711,4368
05,DISTRICT,"Almora
",Total,622506,291081,331425
05,DISTRICT,"Almora
",Rural,560192,257359,302833
05,DISTRICT,"Almora
",Urban,62314,33722,28592
05,DISTRICT,Champawat,Total,259648,131125,128523
05,DISTRICT,Champawat,Rural,221305,110842,110463
05,DISTRICT,Champawat,Urban,38343,20283,18060
05,DISTRICT,Nainital,Total,954605,493666,460939
05,DISTRICT,Nainital,Rural,582871,299257,283614
05,DISTRICT,Nainital,Urban,371734,194409,177325
05,DISTRICT,Udham Singh Nagar,Total,1648902,858783,790119
05,DISTRICT,Udham Singh Nagar,Rural,1062142,550470,511672
05,DISTRICT,Udham Singh Nagar,Urban,586760,308313,278447
05,DISTRICT,Hardwar,Total,1890422,1005295,885127
05,DISTRICT,Hardwar,Rural,1197328,633784,563544
05,DISTRICT,Hardwar,Urban,693094,371511,321583
06,STATE,HARYANA,Total,25351462,13494734,11856728
06,STATE,HARYANA,Rural,16509359,8774006,7735353
06,STATE,HARYANA,Urban,8842103,4720728,4121375
06,DISTRICT,Panchkula,Total,561293,299679,261614
06,DISTRICT,Panchkula,Rural,248063,133153,114910
06,DISTRICT,Panchkula,Urban,313230,166526,146704
06,DISTRICT,Ambala,Total,1128350,598703,529647
06,DISTRICT,Ambala,Rural,627576,331703,295873
06,DISTRICT,Ambala,Urban,500774,267000,233774
06,DISTRICT,Yamunanagar,Total,1214205,646718,567487
06,DISTRICT,Yamunanagar,Rural,741376,393957,347419
06,DISTRICT,Yamunanagar,Urban,472829,252761,220068
06,DISTRICT,Kurukshetra,Total,964655,510976,453679
06,DISTRICT,Kurukshetra,Rural,685430,361020,324410
06,DISTRICT,Kurukshetra,Urban,279225,149956,129269
06,DISTRICT,Kaithal,Total,1074304,571003,503301
06,DISTRICT,Kaithal,Rural,838293,445931,392362
06,DISTRICT,Kaithal,Urban,236011,125072,110939
06,DISTRICT,Karnal,Total,1505324,797712,707612
06,DISTRICT,Karnal,Rural,1050514,557110,493404
06,DISTRICT,Karnal,Urban,454810,240602,214208
06,DISTRICT,Panipat,Total,1205437,646857,558580
06,DISTRICT,Panipat,Rural,650352,349642,300710
06,DISTRICT,Panipat,Urban,555085,297215,257870
06,DISTRICT,Sonipat,Total,1450001,781299,668702
06,DISTRICT,Sonipat,Rural,996637,538750,457887
06,DISTRICT,Sonipat,Urban,453364,242549,210815
06,DISTRICT,Jind,Total,1334152,713006,621146
06,DISTRICT,Jind,Rural,1028569,550519,478050
06,DISTRICT,Jind,Urban,305583,162487,143096
06,DISTRICT,Fatehabad,Total,942011,495360,446651
06,DISTRICT,Fatehabad,Rural,762423,400814,361609
06,DISTRICT,Fatehabad,Urban,179588,94546,85042
06,DISTRICT,Sirsa,Total,1295189,682582,612607
06,DISTRICT,Sirsa,Rural,975941,514177,461764
06,DISTRICT,Sirsa,Urban,319248,168405,150843
06,DISTRICT,Hisar,Total,1743931,931562,812369
06,DISTRICT,Hisar,Rural,1190443,634139,556304
06,DISTRICT,Hisar,Urban,553488,297423,256065
06,DISTRICT,Bhiwani,Total,1634445,866672,767773
06,DISTRICT,Bhiwani,Rural,1313123,696212,616911
06,DISTRICT,Bhiwani,Urban,321322,170460,150862
06,DISTRICT,Rohtak,Total,1061204,568479,492725
06,DISTRICT,Rohtak,Rural,615040,332034,283006
06,DISTRICT,Rohtak,Urban,446164,236445,209719
06,DISTRICT,Jhajjar,Total,958405,514667,443738
06,DISTRICT,Jhajjar,Rural,715066,384219,330847
06,DISTRICT,Jhajjar,Urban,243339,130448,112891
06,DISTRICT,Mahendragarh,Total,922088,486665,435423
06,DISTRICT,Mahendragarh,Rural,789233,416358,372875
06,DISTRICT,Mahendragarh,Urban,132855,70307,62548
06,DISTRICT,Rewari,Total,900332,474335,425997
06,DISTRICT,Rewari,Rural,666902,349710,317192
06,DISTRICT,Rewari,Urban,233430,124625,108805
06,DISTRICT,Gurgaon,Total,1514432,816690,697742
06,DISTRICT,Gurgaon,Rural,472179,251462,220717
06,DISTRICT,Gurgaon,Urban,1042253,565228,477025
06,DISTRICT,Mewat ,Total,1089263,571162,518101
06,DISTRICT,Mewat ,Rural,965157,506086,459071
06,DISTRICT,Mewat ,Urban,124106,65076,59030
06,DISTRICT,Faridabad,Total,1809733,966110,843623
06,DISTRICT,Faridabad,Rural,370878,198103,172775
06,DISTRICT,Faridabad,Urban,1438855,768007,670848
06,DISTRICT,Palwal ,Total,1042708,554497,488211
06,DISTRICT,Palwal ,Rural,806164,428907,377257
06,DISTRICT,Palwal ,Urban,236544,125590,110954
07,STATE,NCT OF DELHI,Total,16787941,8987326,7800615
07,STATE,NCT OF DELHI,Rural,419042,226321,192721
07,STATE,NCT OF DELHI,Urban,16368899,8761005,7607894
07,DISTRICT,North West,Total,3656539,1960922,1695617
07,DISTRICT,North West,Rural,213950,115680,98270
07,DISTRICT,North West,Urban,3442589,1845242,1597347
07,DISTRICT,North,Total,887978,475002,412976
07,DISTRICT,North,Rural,17746,9546,8200
07,DISTRICT,North,Urban,870232,465456,404776
07,DISTRICT,North East,Total,2241624,1188425,1053199
07,DISTRICT,North East,Rural,21527,11718,9809
07,DISTRICT,North East,Urban,2220097,1176707,1043390
07,DISTRICT,East,Total,1709346,907500,801846
07,DISTRICT,East,Rural,3530,1861,1669
07,DISTRICT,East,Urban,1705816,905639,800177
07,DISTRICT,New Delhi,Total,142004,77942,64062
07,DISTRICT,New Delhi,Rural,0,0,0
07,DISTRICT,New Delhi,Urban,142004,77942,64062
07,DISTRICT,Central,Total,582320,307821,274499
07,DISTRICT,Central,Rural,0,0,0
07,DISTRICT,Central,Urban,582320,307821,274499
07,DISTRICT,West,Total,2543243,1356240,1187003
07,DISTRICT,West,Rural,6420,3355,3065
07,DISTRICT,West,Urban,2536823,1352885,1183938
07,DISTRICT,South West,Total,2292958,1246046,1046912
07,DISTRICT,South West,Rural,143676,77342,66334
07,DISTRICT,South West,Urban,2149282,1168704,980578
07,DISTRICT,South,Total,2731929,1467428,1264501
07,DISTRICT,South,Rural,12193,6819,5374
07,DISTRICT,South,Urban,2719736,1460609,1259127
08,STATE,RAJASTHAN,Total,68548437,35550997,32997440
08,STATE,RAJASTHAN,Rural,51500352,26641747,24858605
08,STATE,RAJASTHAN,Urban,17048085,8909250,8138835
08,DISTRICT,Ganganagar ,Total,1969168,1043340,925828
08,DISTRICT,Ganganagar ,Rural,1433736,758269,675467
08,DISTRICT,Ganganagar ,Urban,535432,285071,250361
08,DISTRICT,Hanumangarh,Total,1774692,931184,843508
08,DISTRICT,Hanumangarh,Rural,1424228,746887,677341
08,DISTRICT,Hanumangarh,Urban,350464,184297,166167
08,DISTRICT,Bikaner,Total,2363937,1240801,1123136
08,DISTRICT,Bikaner,Rural,1563553,821434,742119
08,DISTRICT,Bikaner,Urban,800384,419367,381017
08,DISTRICT,Churu,Total,2039547,1051446,988101
08,DISTRICT,Churu,Rural,1463312,755028,708284
08,DISTRICT,Churu,Urban,576235,296418,279817
08,DISTRICT,Jhunjhunun,Total,2137045,1095896,1041149
08,DISTRICT,Jhunjhunun,Rural,1647966,842718,805248
08,DISTRICT,Jhunjhunun,Urban,489079,253178,235901
08,DISTRICT,Alwar,Total,3674179,1939026,1735153
08,DISTRICT,Alwar,Rural,3019728,1589508,1430220
08,DISTRICT,Alwar,Urban,654451,349518,304933
08,DISTRICT,Bharatpur,Total,2548462,1355726,1192736
08,DISTRICT,Bharatpur,Rural,2053363,1093357,960006
08,DISTRICT,Bharatpur,Urban,495099,262369,232730
08,DISTRICT,Dhaulpur,Total,1206516,653647,552869
08,DISTRICT,Dhaulpur,Rural,959066,520930,438136
08,DISTRICT,Dhaulpur,Urban,247450,132717,114733
08,DISTRICT,Karauli,Total,1458248,783639,674609
08,DISTRICT,Karauli,Rural,1240143,668185,571958
08,DISTRICT,Karauli,Urban,218105,115454,102651
08,DISTRICT,Sawai Madhopur,Total,1335551,704031,631520
08,DISTRICT,Sawai Madhopur,Rural,1069084,564592,504492
08,DISTRICT,Sawai Madhopur,Urban,266467,139439,127028
08,DISTRICT,Dausa,Total,1634409,857787,776622
08,DISTRICT,Dausa,Rural,1432616,751900,680716
08,DISTRICT,Dausa,Urban,201793,105887,95906
08,DISTRICT,Jaipur,Total,6626178,3468507,3157671
08,DISTRICT,Jaipur,Rural,3154331,1642924,1511407
08,DISTRICT,Jaipur,Urban,3471847,1825583,1646264
08,DISTRICT,Sikar,Total,2677333,1374990,1302343
08,DISTRICT,Sikar,Rural,2043427,1047469,995958
08,DISTRICT,Sikar,Urban,633906,327521,306385
08,DISTRICT,Nagaur,Total,3307743,1696325,1611418
08,DISTRICT,Nagaur,Rural,2670539,1368771,1301768
08,DISTRICT,Nagaur,Urban,637204,327554,309650
08,DISTRICT,Jodhpur,Total,3687165,1923928,1763237
08,DISTRICT,Jodhpur,Rural,2422551,1260328,1162223
08,DISTRICT,Jodhpur,Urban,1264614,663600,601014
08,DISTRICT,Jaisalmer,Total,669919,361708,308211
08,DISTRICT,Jaisalmer,Rural,580894,312447,268447
08,DISTRICT,Jaisalmer,Urban,89025,49261,39764
08,DISTRICT,Barmer,Total,2603751,1369022,1234729
08,DISTRICT,Barmer,Rural,2421914,1273249,1148665
08,DISTRICT,Barmer,Urban,181837,95773,86064
08,DISTRICT,Jalor,Total,1828730,936634,892096
08,DISTRICT,Jalor,Rural,1676975,857619,819356
08,DISTRICT,Jalor,Urban,151755,79015,72740
08,DISTRICT,Sirohi,Total,1036346,534231,502115
08,DISTRICT,Sirohi,Rural,827692,424252,403440
08,DISTRICT,Sirohi,Urban,208654,109979,98675
08,DISTRICT,Pali,Total,2037573,1025422,1012151
08,DISTRICT,Pali,Rural,1577567,787559,790008
08,DISTRICT,Pali,Urban,460006,237863,222143
08,DISTRICT,Ajmer,Total,2583052,1324085,1258967
08,DISTRICT,Ajmer,Rural,1547642,789397,758245
08,DISTRICT,Ajmer,Urban,1035410,534688,500722
08,DISTRICT,Tonk,Total,1421326,728136,693190
08,DISTRICT,Tonk,Rural,1103603,568045,535558
08,DISTRICT,Tonk,Urban,317723,160091,157632
08,DISTRICT,Bundi,Total,1110906,577160,533746
08,DISTRICT,Bundi,Rural,888205,461734,426471
08,DISTRICT,Bundi,Urban,222701,115426,107275
08,DISTRICT,Bhilwara,Total,2408523,1220736,1187787
08,DISTRICT,Bhilwara,Rural,1895869,955378,940491
08,DISTRICT,Bhilwara,Urban,512654,265358,247296
08,DISTRICT,Rajsamand,Total,1156597,581339,575258
08,DISTRICT,Rajsamand,Rural,972777,486960,485817
08,DISTRICT,Rajsamand,Urban,183820,94379,89441
08,DISTRICT,Dungarpur,Total,1388552,696532,692020
08,DISTRICT,Dungarpur,Rural,1299809,651046,648763
08,DISTRICT,Dungarpur,Urban,88743,45486,43257
08,DISTRICT,Banswara,Total,1797485,907754,889731
08,DISTRICT,Banswara,Rural,1669864,842767,827097
08,DISTRICT,Banswara,Urban,127621,64987,62634
08,DISTRICT,Chittaurgarh,Total,1544338,783171,761167
08,DISTRICT,Chittaurgarh,Rural,1259074,636415,622659
08,DISTRICT,Chittaurgarh,Urban,285264,146756,138508
08,DISTRICT,Kota,Total,1951014,1021161,929853
08,DISTRICT,Kota,Rural,774410,401331,373079
08,DISTRICT,Kota,Urban,1176604,619830,556774
08,DISTRICT,Baran,Total,1222755,633945,588810
08,DISTRICT,Baran,Rural,968541,502228,466313
08,DISTRICT,Baran,Urban,254214,131717,122497
08,DISTRICT,Jhalawar,Total,1411129,725143,685986
08,DISTRICT,Jhalawar,Rural,1181838,606533,575305
08,DISTRICT,Jhalawar,Urban,229291,118610,110681
08,DISTRICT,Udaipur,Total,3068420,1566801,1501619
08,DISTRICT,Udaipur,Rural,2459994,1251316,1208678
08,DISTRICT,Udaipur,Urban,608426,315485,292941
08,DISTRICT,Pratapgarh,Total,867848,437744,430104
08,DISTRICT,Pratapgarh,Rural,796041,401171,394870
08,DISTRICT,Pratapgarh,Urban,71807,36573,35234
09,STATE,UTTAR PRADESH,Total,199812341,104480510,95331831
09,STATE,UTTAR PRADESH,Rural,155317278,80992995,74324283
09,STATE,UTTAR PRADESH,Urban,44495063,23487515,21007548
09,DISTRICT,Saharanpur,Total,3466382,1834106,1632276
09,DISTRICT,Saharanpur,Rural,2399856,1269803,1130053
09,DISTRICT,Saharanpur,Urban,1066526,564303,502223
09,DISTRICT,Muzaffarnagar,Total,4143512,2193434,1950078
09,DISTRICT,Muzaffarnagar,Rural,2952200,1565004,1387196
09,DISTRICT,Muzaffarnagar,Urban,1191312,628430,562882
09,DISTRICT,Bijnor,Total,3682713,1921215,1761498
09,DISTRICT,Bijnor,Rural,2757401,1438412,1318989
09,DISTRICT,Bijnor,Urban,925312,482803,442509
09,DISTRICT,Moradabad,Total,4772006,2503186,2268820
09,DISTRICT,Moradabad,Rural,3198383,1680022,1518361
09,DISTRICT,Moradabad,Urban,1573623,823164,750459
09,DISTRICT,Rampur,Total,2335819,1223889,1111930
09,DISTRICT,Rampur,Rural,1747172,916878,830294
09,DISTRICT,Rampur,Urban,588647,307011,281636
09,DISTRICT,Jyotiba Phule Nagar,Total,1840221,963449,876772
09,DISTRICT,Jyotiba Phule Nagar,Rural,1381508,724539,656969
09,DISTRICT,Jyotiba Phule Nagar,Urban,458713,238910,219803
09,DISTRICT,Meerut,Total,3443689,1825743,1617946
09,DISTRICT,Meerut,Rural,1684507,894920,789587
09,DISTRICT,Meerut,Urban,1759182,930823,828359
09,DISTRICT,Baghpat,Total,1303048,700070,602978
09,DISTRICT,Baghpat,Rural,1028023,553807,474216
09,DISTRICT,Baghpat,Urban,275025,146263,128762
09,DISTRICT,Ghaziabad,Total,4681645,2488834,2192811
09,DISTRICT,Ghaziabad,Rural,1519098,808222,710876
09,DISTRICT,Ghaziabad,Urban,3162547,1680612,1481935
09,DISTRICT,Gautam Buddha Nagar,Total,1648115,890214,757901
09,DISTRICT,Gautam Buddha Nagar,Rural,673806,359605,314201
09,DISTRICT,Gautam Buddha Nagar,Urban,974309,530609,443700
09,DISTRICT,Bulandshahr ,Total,3499171,1845260,1653911
09,DISTRICT,Bulandshahr ,Rural,2631742,1390490,1241252
09,DISTRICT,Bulandshahr ,Urban,867429,454770,412659
09,DISTRICT,Aligarh,Total,3673889,1951996,1721893
09,DISTRICT,Aligarh,Rural,2456698,1308923,1147775
09,DISTRICT,Aligarh,Urban,1217191,643073,574118
09,DISTRICT,Mahamaya Nagar,Total,1564708,836127,728581
09,DISTRICT,Mahamaya Nagar,Rural,1232015,659814,572201
09,DISTRICT,Mahamaya Nagar,Urban,332693,176313,156380
09,DISTRICT,Mathura,Total,2547184,1367125,1180059
09,DISTRICT,Mathura,Rural,1791191,962028,829163
09,DISTRICT,Mathura,Urban,755993,405097,350896
09,DISTRICT,Agra,Total,4418797,2364953,2053844
09,DISTRICT,Agra,Rural,2394602,1285184,1109418
09,DISTRICT,Agra,Urban,2024195,1079769,944426
09,DISTRICT,Firozabad,Total,2498156,1332046,1166110
09,DISTRICT,Firozabad,Rural,1664987,891872,773115
09,DISTRICT,Firozabad,Urban,833169,440174,392995
09,DISTRICT,Mainpuri,Total,1868529,993377,875152
09,DISTRICT,Mainpuri,Rural,1580087,842374,737713
09,DISTRICT,Mainpuri,Urban,288442,151003,137439
09,DISTRICT,Budaun,Total,3681896,1967759,1714137
09,DISTRICT,Budaun,Rural,3037301,1630376,1406925
09,DISTRICT,Budaun,Urban,644595,337383,307212
09,DISTRICT,Bareilly,Total,4448359,2357665,2090694
09,DISTRICT,Bareilly,Rural,2879950,1530356,1349594
09,DISTRICT,Bareilly,Urban,1568409,827309,741100
09,DISTRICT,Pilibhit,Total,2031007,1072002,959005
09,DISTRICT,Pilibhit,Rural,1679592,886789,792803
09,DISTRICT,Pilibhit,Urban,351415,185213,166202
09,DISTRICT,Shahjahanpur,Total,3006538,1606403,1400135
09,DISTRICT,Shahjahanpur,Rural,2412446,1293714,1118732
09,DISTRICT,Shahjahanpur,Urban,594092,312689,281403
09,DISTRICT,Kheri,Total,4021243,2123187,1898056
09,DISTRICT,Kheri,Rural,3560208,1880679,1679529
09,DISTRICT,Kheri,Urban,461035,242508,218527
09,DISTRICT,Sitapur,Total,4483992,2375264,2108728
09,DISTRICT,Sitapur,Rural,3953208,2098123,1855085
09,DISTRICT,Sitapur,Urban,530784,277141,253643
09,DISTRICT,Hardoi,Total,4092845,2191442,1901403
09,DISTRICT,Hardoi,Rural,3551039,1906147,1644892
09,DISTRICT,Hardoi,Urban,541806,285295,256511
09,DISTRICT,Unnao,Total,3108367,1630087,1478280
09,DISTRICT,Unnao,Rural,2576721,1351897,1224824
09,DISTRICT,Unnao,Urban,531646,278190,253456
09,DISTRICT,Lucknow,Total,4589838,2394476,2195362
09,DISTRICT,Lucknow,Rural,1550842,813752,737090
09,DISTRICT,Lucknow,Urban,3038996,1580724,1458272
09,DISTRICT,Rae Bareli,Total,3405559,1752542,1653017
09,DISTRICT,Rae Bareli,Rural,3097564,1592449,1505115
09,DISTRICT,Rae Bareli,Urban,307995,160093,147902
09,DISTRICT,Farrukhabad,Total,1885204,1006240,878964
09,DISTRICT,Farrukhabad,Rural,1469019,785301,683718
09,DISTRICT,Farrukhabad,Urban,416185,220939,195246
09,DISTRICT,Kannauj,Total,1656616,881776,774840
09,DISTRICT,Kannauj,Rural,1375775,734245,641530
09,DISTRICT,Kannauj,Urban,280841,147531,133310
09,DISTRICT,Etawah,Total,1581810,845856,735954
09,DISTRICT,Etawah,Rural,1215511,652740,562771
09,DISTRICT,Etawah,Urban,366299,193116,173183
09,DISTRICT,Auraiya,Total,1379545,740040,639505
09,DISTRICT,Auraiya,Rural,1145323,616494,528829
09,DISTRICT,Auraiya,Urban,234222,123546,110676
09,DISTRICT,Kanpur Dehat,Total,1796184,963255,832929
09,DISTRICT,Kanpur Dehat,Rural,1622761,871508,751253
09,DISTRICT,Kanpur Dehat,Urban,173423,91747,81676
09,DISTRICT,Kanpur Nagar,Total,4581268,2459806,2121462
09,DISTRICT,Kanpur Nagar,Rural,1565623,837260,728363
09,DISTRICT,Kanpur Nagar,Urban,3015645,1622546,1393099
09,DISTRICT,Jalaun ,Total,1689974,906092,783882
09,DISTRICT,Jalaun ,Rural,1271074,683656,587418
09,DISTRICT,Jalaun ,Urban,418900,222436,196464
09,DISTRICT,Jhansi,Total,1998603,1057436,941167
09,DISTRICT,Jhansi,Rural,1165119,615629,549490
09,DISTRICT,Jhansi,Urban,833484,441807,391677
09,DISTRICT,Lalitpur,Total,1221592,641011,580581
09,DISTRICT,Lalitpur,Rural,1046214,549478,496736
09,DISTRICT,Lalitpur,Urban,175378,91533,83845
09,DISTRICT,Hamirpur,Total,1104285,593537,510748
09,DISTRICT,Hamirpur,Rural,894437,481373,413064
09,DISTRICT,Hamirpur,Urban,209848,112164,97684
09,DISTRICT,Mahoba,Total,875958,466358,409600
09,DISTRICT,Mahoba,Rural,690577,368009,322568
09,DISTRICT,Mahoba,Urban,185381,98349,87032
09,DISTRICT,Banda,Total,1799410,965876,833534
09,DISTRICT,Banda,Rural,1523655,819243,704412
09,DISTRICT,Banda,Urban,275755,146633,129122
09,DISTRICT,Chitrakoot,Total,991730,527721,464009
09,DISTRICT,Chitrakoot,Rural,895398,476794,418604
09,DISTRICT,Chitrakoot,Urban,96332,50927,45405
09,DISTRICT,Fatehpur,Total,2632733,1384722,1248011
09,DISTRICT,Fatehpur,Rural,2310740,1215690,1095050
09,DISTRICT,Fatehpur,Urban,321993,169032,152961
09,DISTRICT,Pratapgarh,Total,3209141,1606085,1603056
09,DISTRICT,Pratapgarh,Rural,3033899,1515583,1518316
09,DISTRICT,Pratapgarh,Urban,175242,90502,84740
09,DISTRICT,Kaushambi,Total,1599596,838485,761111
09,DISTRICT,Kaushambi,Rural,1475140,773335,701805
09,DISTRICT,Kaushambi,Urban,124456,65150,59306
09,DISTRICT,Allahabad ,Total,5954391,3131807,2822584
09,DISTRICT,Allahabad ,Rural,4481518,2340959,2140559
09,DISTRICT,Allahabad ,Urban,1472873,790848,682025
09,DISTRICT,Bara Banki,Total,3260699,1707073,1553626
09,DISTRICT,Bara Banki,Rural,2929896,1533455,1396441
09,DISTRICT,Bara Banki,Urban,330803,173618,157185
09,DISTRICT,Faizabad,Total,2470996,1259628,1211368
09,DISTRICT,Faizabad,Rural,2130743,1079257,1051486
09,DISTRICT,Faizabad,Urban,340253,180371,159882
09,DISTRICT,Ambedkar Nagar,Total,2397888,1212410,1185478
09,DISTRICT,Ambedkar Nagar,Rural,2117158,1067762,1049396
09,DISTRICT,Ambedkar Nagar,Urban,280730,144648,136082
09,DISTRICT,Sultanpur,Total,3797117,1914586,1882531
09,DISTRICT,Sultanpur,Rural,3597201,1810496,1786705
09,DISTRICT,Sultanpur,Urban,199916,104090,95826
09,DISTRICT,Bahraich,Total,3487731,1843884,1643847
09,DISTRICT,Bahraich,Rural,3203687,1695122,1508565
09,DISTRICT,Bahraich,Urban,284044,148762,135282
09,DISTRICT,Shrawasti,Total,1117361,593897,523464
09,DISTRICT,Shrawasti,Rural,1078712,573681,505031
09,DISTRICT,Shrawasti,Urban,38649,20216,18433
09,DISTRICT,Balrampur,Total,2148665,1114721,1033944
09,DISTRICT,Balrampur,Rural,1982274,1027943,954331
09,DISTRICT,Balrampur,Urban,166391,86778,79613
09,DISTRICT,Gonda,Total,3433919,1787146,1646773
09,DISTRICT,Gonda,Rural,3208890,1669058,1539832
09,DISTRICT,Gonda,Urban,225029,118088,106941
09,DISTRICT,Siddharthnagar,Total,2559297,1295095,1264202
09,DISTRICT,Siddharthnagar,Rural,2398606,1212141,1186465
09,DISTRICT,Siddharthnagar,Urban,160691,82954,77737
09,DISTRICT,Basti,Total,2464464,1255272,1209192
09,DISTRICT,Basti,Rural,2326367,1182846,1143521
09,DISTRICT,Basti,Urban,138097,72426,65671
09,DISTRICT,Sant Kabir Nagar,Total,1715183,869656,845527
09,DISTRICT,Sant Kabir Nagar,Rural,1586652,802609,784043
09,DISTRICT,Sant Kabir Nagar,Urban,128531,67047,61484
09,DISTRICT,Mahrajganj,Total,2684703,1381754,1302949
09,DISTRICT,Mahrajganj,Rural,2549973,1312126,1237847
09,DISTRICT,Mahrajganj,Urban,134730,69628,65102
09,DISTRICT,Gorakhpur,Total,4440895,2277777,2163118
09,DISTRICT,Gorakhpur,Rural,3604766,1838726,1766040
09,DISTRICT,Gorakhpur,Urban,836129,439051,397078
09,DISTRICT,Kushinagar,Total,3564544,1818055,1746489
09,DISTRICT,Kushinagar,Rural,3396437,1730377,1666060
09,DISTRICT,Kushinagar,Urban,168107,87678,80429
09,DISTRICT,Deoria,Total,3100946,1537436,1563510
09,DISTRICT,Deoria,Rural,2784143,1373111,1411032
09,DISTRICT,Deoria,Urban,316803,164325,152478
09,DISTRICT,Azamgarh,Total,4613913,2285004,2328909
09,DISTRICT,Azamgarh,Rural,4220512,2082707,2137805
09,DISTRICT,Azamgarh,Urban,393401,202297,191104
09,DISTRICT,Mau,Total,2205968,1114709,1091259
09,DISTRICT,Mau,Rural,1706760,858843,847917
09,DISTRICT,Mau,Urban,499208,255866,243342
09,DISTRICT,Ballia,Total,3239774,1672902,1566872
09,DISTRICT,Ballia,Rural,2935665,1514018,1421647
09,DISTRICT,Ballia,Urban,304109,158884,145225
09,DISTRICT,Jaunpur,Total,4494204,2220465,2273739
09,DISTRICT,Jaunpur,Rural,4147624,2041217,2106407
09,DISTRICT,Jaunpur,Urban,346580,179248,167332
09,DISTRICT,Ghazipur,Total,3620268,1855075,1765193
09,DISTRICT,Ghazipur,Rural,3345908,1711651,1634257
09,DISTRICT,Ghazipur,Urban,274360,143424,130936
09,DISTRICT,Chandauli,Total,1952756,1017905,934851
09,DISTRICT,Chandauli,Rural,1710203,890630,819573
09,DISTRICT,Chandauli,Urban,242553,127275,115278
09,DISTRICT,Varanasi,Total,3676841,1921857,1754984
09,DISTRICT,Varanasi,Rural,2079790,1076526,1003264
09,DISTRICT,Varanasi,Urban,1597051,845331,751720
09,DISTRICT,Sant Ravidas Nagar (Bhadohi),Total,1578213,807099,771114
09,DISTRICT,Sant Ravidas Nagar (Bhadohi),Rural,1348911,686589,662322
09,DISTRICT,Sant Ravidas Nagar (Bhadohi),Urban,229302,120510,108792
09,DISTRICT,Mirzapur,Total,2496970,1312302,1184668
09,DISTRICT,Mirzapur,Rural,2149403,1127138,1022265
09,DISTRICT,Mirzapur,Urban,347567,185164,162403
09,DISTRICT,Sonbhadra,Total,1862559,971344,891215
09,DISTRICT,Sonbhadra,Rural,1548217,803345,744872
09,DISTRICT,Sonbhadra,Urban,314342,167999,146343
09,DISTRICT,Etah,Total,1774480,947339,827141
09,DISTRICT,Etah,Rural,1506338,805589,700749
09,DISTRICT,Etah,Urban,268142,141750,126392
09,DISTRICT,Kanshiram Nagar,Total,1436719,764165,672554
09,DISTRICT,Kanshiram Nagar,Rural,1148512,612556,535956
09,DISTRICT,Kanshiram Nagar,Urban,288207,151609,136598
10,STATE,BIHAR,Total,104099452,54278157,49821295
10,STATE,BIHAR,Rural,92341436,48073850,44267586
10,STATE,BIHAR,Urban,11758016,6204307,5553709
10,DISTRICT,Pashchim Champaran,Total,3935042,2061110,1873932
10,DISTRICT,Pashchim Champaran,Rural,3541877,1853809,1688068
10,DISTRICT,Pashchim Champaran,Urban,393165,207301,185864
10,DISTRICT,Purba Champaran,Total,5099371,2681209,2418162
10,DISTRICT,Purba Champaran,Rural,4698028,2468181,2229847
10,DISTRICT,Purba Champaran,Urban,401343,213028,188315
10,DISTRICT,Sheohar,Total,656246,346673,309573
10,DISTRICT,Sheohar,Rural,628130,331792,296338
10,DISTRICT,Sheohar,Urban,28116,14881,13235
10,DISTRICT,Sitamarhi,Total,3423574,1803252,1620322
10,DISTRICT,Sitamarhi,Rural,3233076,1701685,1531391
10,DISTRICT,Sitamarhi,Urban,190498,101567,88931
10,DISTRICT,Madhubani,Total,4487379,2329313,2158066
10,DISTRICT,Madhubani,Rural,4325884,2244287,2081597
10,DISTRICT,Madhubani,Urban,161495,85026,76469
10,DISTRICT,Supaul,Total,2229076,1155283,1073793
10,DISTRICT,Supaul,Rural,2123518,1099495,1024023
10,DISTRICT,Supaul,Urban,105558,55788,49770
10,DISTRICT,Araria,Total,2811569,1463333,1348236
10,DISTRICT,Araria,Rural,2642792,1374254,1268538
10,DISTRICT,Araria,Urban,168777,89079,79698
10,DISTRICT,Kishanganj,Total,1690400,866970,823430
10,DISTRICT,Kishanganj,Rural,1529277,783318,745959
10,DISTRICT,Kishanganj,Urban,161123,83652,77471
10,DISTRICT,Purnia,Total,3264619,1699370,1565249
10,DISTRICT,Purnia,Rural,2921614,1519522,1402092
10,DISTRICT,Purnia,Urban,343005,179848,163157
10,DISTRICT,Katihar,Total,3071029,1600430,1470599
10,DISTRICT,Katihar,Rural,2797207,1455744,1341463
10,DISTRICT,Katihar,Urban,273822,144686,129136
10,DISTRICT,Madhepura,Total,2001762,1047559,954203
10,DISTRICT,Madhepura,Rural,1913301,1000760,912541
10,DISTRICT,Madhepura,Urban,88461,46799,41662
10,DISTRICT,Saharsa,Total,1900661,997174,903487
10,DISTRICT,Saharsa,Rural,1744121,913883,830238
10,DISTRICT,Saharsa,Urban,156540,83291,73249
10,DISTRICT,Darbhanga,Total,3937385,2059949,1877436
10,DISTRICT,Darbhanga,Rural,3554057,1858545,1695512
10,DISTRICT,Darbhanga,Urban,383328,201404,181924
10,DISTRICT,Muzaffarpur,Total,4801062,2527497,2273565
10,DISTRICT,Muzaffarpur,Rural,4327625,2276812,2050813
10,DISTRICT,Muzaffarpur,Urban,473437,250685,222752
10,DISTRICT,Gopalganj,Total,2562012,1267666,1294346
10,DISTRICT,Gopalganj,Rural,2399207,1184967,1214240
10,DISTRICT,Gopalganj,Urban,162805,82699,80106
10,DISTRICT,Siwan,Total,3330464,1675090,1655374
10,DISTRICT,Siwan,Rural,3147551,1579685,1567866
10,DISTRICT,Siwan,Urban,182913,95405,87508
10,DISTRICT,Saran,Total,3951862,2022821,1929041
10,DISTRICT,Saran,Rural,3598660,1838119,1760541
10,DISTRICT,Saran,Urban,353202,184702,168500
10,DISTRICT,Vaishali,Total,3495021,1844535,1650486
10,DISTRICT,Vaishali,Rural,3261942,1721221,1540721
10,DISTRICT,Vaishali,Urban,233079,123314,109765
10,DISTRICT,Samastipur,Total,4261566,2230003,2031563
10,DISTRICT,Samastipur,Rural,4113769,2152273,1961496
10,DISTRICT,Samastipur,Urban,147797,77730,70067
10,DISTRICT,Begusarai,Total,2970541,1567660,1402881
10,DISTRICT,Begusarai,Rural,2400718,1266308,1134410
10,DISTRICT,Begusarai,Urban,569823,301352,268471
10,DISTRICT,Khagaria,Total,1666886,883786,783100
10,DISTRICT,Khagaria,Rural,1579727,837281,742446
10,DISTRICT,Khagaria,Urban,87159,46505,40654
10,DISTRICT,Bhagalpur,Total,3037766,1615663,1422103
10,DISTRICT,Bhagalpur,Rural,2435234,1295386,1139848
10,DISTRICT,Bhagalpur,Urban,602532,320277,282255
10,DISTRICT,Banka,Total,2034763,1067140,967623
10,DISTRICT,Banka,Rural,1963450,1029097,934353
10,DISTRICT,Banka,Urban,71313,38043,33270
10,DISTRICT,Munger,Total,1367765,729041,638724
10,DISTRICT,Munger,Rural,987645,527299,460346
10,DISTRICT,Munger,Urban,380120,201742,178378
10,DISTRICT,Lakhisarai,Total,1000912,526345,474567
10,DISTRICT,Lakhisarai,Rural,857901,450863,407038
10,DISTRICT,Lakhisarai,Urban,143011,75482,67529
10,DISTRICT,Sheikhpura,Total,636342,329743,306599
10,DISTRICT,Sheikhpura,Rural,527340,272360,254980
10,DISTRICT,Sheikhpura,Urban,109002,57383,51619
10,DISTRICT,Nalanda,Total,2877653,1497060,1380593
10,DISTRICT,Nalanda,Rural,2419759,1257728,1162031
10,DISTRICT,Nalanda,Urban,457894,239332,218562
10,DISTRICT,Patna,Total,5838465,3078512,2759953
10,DISTRICT,Patna,Rural,3323875,1746025,1577850
10,DISTRICT,Patna,Urban,2514590,1332487,1182103
10,DISTRICT,Bhojpur,Total,2728407,1430380,1298027
10,DISTRICT,Bhojpur,Rural,2338546,1224274,1114272
10,DISTRICT,Bhojpur,Urban,389861,206106,183755
10,DISTRICT,Buxar,Total,1706352,887977,818375
10,DISTRICT,Buxar,Rural,1541853,801086,740767
10,DISTRICT,Buxar,Urban,164499,86891,77608
10,DISTRICT,Kaimur (Bhabua),Total,1626384,847006,779378
10,DISTRICT,Kaimur (Bhabua),Rural,1560813,812298,748515
10,DISTRICT,Kaimur (Bhabua),Urban,65571,34708,30863
10,DISTRICT,Rohtas,Total,2959918,1543546,1416372
10,DISTRICT,Rohtas,Rural,2532153,1318276,1213877
10,DISTRICT,Rohtas,Urban,427765,225270,202495
10,DISTRICT,Aurangabad,Total,2540073,1318684,1221389
10,DISTRICT,Aurangabad,Rural,2303219,1194619,1108600
10,DISTRICT,Aurangabad,Urban,236854,124065,112789
10,DISTRICT,Gaya,Total,4391418,2266566,2124852
10,DISTRICT,Gaya,Rural,3809817,1960592,1849225
10,DISTRICT,Gaya,Urban,581601,305974,275627
10,DISTRICT,Nawada,Total,2219146,1144668,1074478
10,DISTRICT,Nawada,Rural,2003567,1031656,971911
10,DISTRICT,Nawada,Urban,215579,113012,102567
10,DISTRICT,Jamui,Total,1760405,916064,844341
10,DISTRICT,Jamui,Rural,1615072,839776,775296
10,DISTRICT,Jamui,Urban,145333,76288,69045
10,DISTRICT,Jehanabad ,Total,1125313,585582,539731
10,DISTRICT,Jehanabad ,Rural,990117,514154,475963
10,DISTRICT,Jehanabad ,Urban,135196,71428,63768
10,DISTRICT,Arwal,Total,700843,363497,337346
10,DISTRICT,Arwal,Rural,648994,336420,312574
10,DISTRICT,Arwal,Urban,51849,27077,24772
11,STATE,SIKKIM,Total,610577,323070,287507
11,STATE,SIKKIM,Rural,456999,242797,214202
11,STATE,SIKKIM,Urban,153578,80273,73305
11,DISTRICT,North  District,Total,43709,24730,18979
11,DISTRICT,North  District,Rural,39065,22274,16791
11,DISTRICT,North  District,Urban,4644,2456,2188
11,DISTRICT,West District,Total,136435,70238,66197
11,DISTRICT,West District,Rural,131187,67528,63659
11,DISTRICT,West District,Urban,5248,2710,2538
11,DISTRICT,South District,Total,146850,76670,70180
11,DISTRICT,South District,Rural,125651,65848,59803
11,DISTRICT,South District,Urban,21199,10822,10377
11,DISTRICT,East District,Total,283583,151432,132151
11,DISTRICT,East District,Rural,161096,87147,73949
11,DISTRICT,East District,Urban,122487,64285,58202
12,STATE,ARUNACHAL PRADESH,Total,1383727,713912,669815
12,STATE,ARUNACHAL PRADESH,Rural,1066358,546011,520347
12,STATE,ARUNACHAL PRADESH,Urban,317369,167901,149468
12,DISTRICT,Tawang,Total,49977,29151,20826
12,DISTRICT,Tawang,Rural,38775,20792,17983
12,DISTRICT,Tawang,Urban,11202,8359,2843
12,DISTRICT,West Kameng,Total,83947,46155,37792
12,DISTRICT,West Kameng,Rural,68015,37809,30206
12,DISTRICT,West Kameng,Urban,15932,8346,7586
12,DISTRICT,East Kameng,Total,78690,38775,39915
12,DISTRICT,East Kameng,Rural,60340,29506,30834
12,DISTRICT,East Kameng,Urban,18350,9269,9081
12,DISTRICT,Papum Pare,Total,176573,89182,87391
12,DISTRICT,Papum Pare,Rural,79610,39935,39675
12,DISTRICT,Papum Pare,Urban,96963,49247,47716
12,DISTRICT,Upper Subansiri,Total,83448,41758,41690
12,DISTRICT,Upper Subansiri,Rural,70043,34840,35203
12,DISTRICT,Upper Subansiri,Urban,13405,6918,6487
12,DISTRICT,West Siang,Total,112274,58168,54106
12,DISTRICT,West Siang,Rural,87306,44687,42619
12,DISTRICT,West Siang,Urban,24968,13481,11487
12,DISTRICT,East Siang,Total,99214,50116,49098
12,DISTRICT,East Siang,Rural,71579,36147,35432
12,DISTRICT,East Siang,Urban,27635,13969,13666
12,DISTRICT,Upper Siang,Total,35320,18699,16621
12,DISTRICT,Upper Siang,Rural,28780,15335,13445
12,DISTRICT,Upper Siang,Urban,6540,3364,3176
12,DISTRICT,Changlang,Total,148226,76948,71278
12,DISTRICT,Changlang,Rural,128998,66283,62715
12,DISTRICT,Changlang,Urban,19228,10665,8563
12,DISTRICT,Tirap,Total,111975,57604,54371
12,DISTRICT,Tirap,Rural,91165,46185,44980
12,DISTRICT,Tirap,Urban,20810,11419,9391
12,DISTRICT,Lower Subansiri,Total,83030,41843,41187
12,DISTRICT,Lower Subansiri,Rural,70224,35460,34764
12,DISTRICT,Lower Subansiri,Urban,12806,6383,6423
12,DISTRICT,Kurung Kumey,Total,92076,45318,46758
12,DISTRICT,Kurung Kumey,Rural,89731,44072,45659
12,DISTRICT,Kurung Kumey,Urban,2345,1246,1099
12,DISTRICT,Dibang Valley,Total,8004,4414,3590
12,DISTRICT,Dibang Valley,Rural,5620,3098,2522
12,DISTRICT,Dibang Valley,Urban,2384,1316,1068
12,DISTRICT,Lower Dibang Valley,Total,54080,28053,26027
12,DISTRICT,Lower Dibang Valley,Rural,42691,21989,20702
12,DISTRICT,Lower Dibang Valley,Urban,11389,6064,5325
12,DISTRICT,Lohit,Total,145726,76221,69505
12,DISTRICT,Lohit,Rural,113296,58991,54305
12,DISTRICT,Lohit,Urban,32430,17230,15200
12,DISTRICT,Anjaw,Total,21167,11507,9660
12,DISTRICT,Anjaw,Rural,20185,10882,9303
12,DISTRICT,Anjaw,Urban,982,625,357
13,STATE,NAGALAND,Total,1978502,1024649,953853
13,STATE,NAGALAND,Rural,1407536,725472,682064
13,STATE,NAGALAND,Urban,570966,299177,271789
13,DISTRICT,Mon,Total,250260,131753,118507
13,DISTRICT,Mon,Rural,215816,113469,102347
13,DISTRICT,Mon,Urban,34444,18284,16160
13,DISTRICT,Mokokchung,Total,194622,101092,93530
13,DISTRICT,Mokokchung,Rural,138897,71373,67524
13,DISTRICT,Mokokchung,Urban,55725,29719,26006
13,DISTRICT,Zunheboto,Total,140757,71217,69540
13,DISTRICT,Zunheboto,Rural,113160,56786,56374
13,DISTRICT,Zunheboto,Urban,27597,14431,13166
13,DISTRICT,Wokha,Total,166343,84505,81838
13,DISTRICT,Wokha,Rural,131339,66435,64904
13,DISTRICT,Wokha,Urban,35004,18070,16934
13,DISTRICT,Dimapur ,Total,378811,197394,181417
13,DISTRICT,Dimapur ,Rural,180942,93435,87507
13,DISTRICT,Dimapur ,Urban,197869,103959,93910
13,DISTRICT,Phek,Total,163418,83743,79675
13,DISTRICT,Phek,Rural,138843,70529,68314
13,DISTRICT,Phek,Urban,24575,13214,11361
13,DISTRICT,Tuensang,Total,196596,101933,94663
13,DISTRICT,Tuensang,Rural,159822,82462,77360
13,DISTRICT,Tuensang,Urban,36774,19471,17303
13,DISTRICT,Longleng,Total,50484,26502,23982
13,DISTRICT,Longleng,Rural,42871,22511,20360
13,DISTRICT,Longleng,Urban,7613,3991,3622
13,DISTRICT,Kiphire,Total,74004,37830,36174
13,DISTRICT,Kiphire,Rural,57517,29243,28274
13,DISTRICT,Kiphire,Urban,16487,8587,7900
13,DISTRICT,Kohima,Total,267988,138966,129022
13,DISTRICT,Kohima,Rural,146900,76369,70531
13,DISTRICT,Kohima,Urban,121088,62597,58491
13,DISTRICT,Peren,Total,95219,49714,45505
13,DISTRICT,Peren,Rural,81429,42860,38569
13,DISTRICT,Peren,Urban,13790,6854,6936
14,STATE,MANIPUR,Total,2855794,1438586,1417208
14,STATE,MANIPUR,Rural,2021640,1026884,994756
14,STATE,MANIPUR,Urban,834154,411702,422452
14,DISTRICT,Senapati,Total,479148,247323,231825
14,DISTRICT,Senapati,Rural,471672,243603,228069
14,DISTRICT,Senapati,Urban,7476,3720,3756
14,DISTRICT,Tamenglong ,Total,140651,72371,68280
14,DISTRICT,Tamenglong ,Rural,121288,62534,58754
14,DISTRICT,Tamenglong ,Urban,19363,9837,9526
14,DISTRICT,Churachandpur,Total,274143,138820,135323
14,DISTRICT,Churachandpur,Rural,255786,129659,126127
14,DISTRICT,Churachandpur,Urban,18357,9161,9196
14,DISTRICT,Bishnupur,Total,237399,118782,118617
14,DISTRICT,Bishnupur,Rural,149894,75171,74723
14,DISTRICT,Bishnupur,Urban,87505,43611,43894
14,DISTRICT,Thoubal,Total,422168,210845,211323
14,DISTRICT,Thoubal,Rural,270835,135470,135365
14,DISTRICT,Thoubal,Urban,151333,75375,75958
14,DISTRICT,Imphal West,Total,517992,255054,262938
14,DISTRICT,Imphal West,Rural,195113,96948,98165
14,DISTRICT,Imphal West,Urban,322879,158106,164773
14,DISTRICT,Imphal East,Total,456113,226094,230019
14,DISTRICT,Imphal East,Rural,272906,136789,136117
14,DISTRICT,Imphal East,Urban,183207,89305,93902
14,DISTRICT,Ukhrul,Total,183998,94718,89280
14,DISTRICT,Ukhrul,Rural,156811,80801,76010
14,DISTRICT,Ukhrul,Urban,27187,13917,13270
14,DISTRICT,Chandel,Total,144182,74579,69603
14,DISTRICT,Chandel,Rural,127335,65909,61426
14,DISTRICT,Chandel,Urban,16847,8670,8177
15,STATE,MIZORAM,Total,1097206,555339,541867
15,STATE,MIZORAM,Rural,525435,269135,256300
15,STATE,MIZORAM,Urban,571771,286204,285567
15,DISTRICT,Mamit,Total,86364,44828,41536
15,DISTRICT,Mamit,Rural,71465,37135,34330
15,DISTRICT,Mamit,Urban,14899,7693,7206
15,DISTRICT,Kolasib,Total,83955,42918,41037
15,DISTRICT,Kolasib,Rural,37077,19097,17980
15,DISTRICT,Kolasib,Urban,46878,23821,23057
15,DISTRICT,Aizawl,Total,400309,199270,201039
15,DISTRICT,Aizawl,Rural,85555,43780,41775
15,DISTRICT,Aizawl,Urban,314754,155490,159264
15,DISTRICT,Champhai,Total,125745,63388,62357
15,DISTRICT,Champhai,Rural,77216,39110,38106
15,DISTRICT,Champhai,Urban,48529,24278,24251
15,DISTRICT,Serchhip,Total,64937,32851,32086
15,DISTRICT,Serchhip,Rural,32918,16643,16275
15,DISTRICT,Serchhip,Urban,32019,16208,15811
15,DISTRICT,Lunglei,Total,161428,82891,78537
15,DISTRICT,Lunglei,Rural,92676,47577,45099
15,DISTRICT,Lunglei,Urban,68752,35314,33438
15,DISTRICT,Lawngtlai,Total,117894,60599,57295
15,DISTRICT,Lawngtlai,Rural,97064,49940,47124
15,DISTRICT,Lawngtlai,Urban,20830,10659,10171
15,DISTRICT,Saiha,Total,56574,28594,27980
15,DISTRICT,Saiha,Rural,31464,15853,15611
15,DISTRICT,Saiha,Urban,25110,12741,12369
16,STATE,TRIPURA,Total,3673917,1874376,1799541
16,STATE,TRIPURA,Rural,2712464,1387173,1325291
16,STATE,TRIPURA,Urban,961453,487203,474250
16,DISTRICT,West Tripura ,Total,1725739,879428,846311
16,DISTRICT,West Tripura ,Rural,1048101,536720,511381
16,DISTRICT,West Tripura ,Urban,677638,342708,334930
16,DISTRICT,South Tripura ,Total,876001,447544,428457
16,DISTRICT,South Tripura ,Rural,752970,384787,368183
16,DISTRICT,South Tripura ,Urban,123031,62757,60274
16,DISTRICT,Dhalai,Total,378230,194544,183686
16,DISTRICT,Dhalai,Rural,337731,173773,163958
16,DISTRICT,Dhalai,Urban,40499,20771,19728
16,DISTRICT,North Tripura,Total,693947,352860,341087
16,DISTRICT,North Tripura,Rural,573662,291893,281769
16,DISTRICT,North Tripura,Urban,120285,60967,59318
17,STATE,MEGHALAYA,Total,2966889,1491832,1475057
17,STATE,MEGHALAYA,Rural,2371439,1194260,1177179
17,STATE,MEGHALAYA,Urban,595450,297572,297878
17,DISTRICT,West Garo Hills,Total,643291,324159,319132
17,DISTRICT,West Garo Hills,Rural,568433,286923,281510
17,DISTRICT,West Garo Hills,Urban,74858,37236,37622
17,DISTRICT,East Garo Hills,Total,317917,161223,156694
17,DISTRICT,East Garo Hills,Rural,273725,138763,134962
17,DISTRICT,East Garo Hills,Urban,44192,22460,21732
17,DISTRICT,South Garo Hills,Total,142334,73170,69164
17,DISTRICT,South Garo Hills,Rural,129203,66470,62733
17,DISTRICT,South Garo Hills,Urban,13131,6700,6431
17,DISTRICT,West Khasi Hills,Total,383461,193715,189746
17,DISTRICT,West Khasi Hills,Rural,340356,172380,167976
17,DISTRICT,West Khasi Hills,Urban,43105,21335,21770
17,DISTRICT,Ribhoi,Total,258840,132531,126309
17,DISTRICT,Ribhoi,Rural,233587,118705,114882
17,DISTRICT,Ribhoi,Urban,25253,13826,11427
17,DISTRICT,East Khasi Hills,Total,825922,410749,415173
17,DISTRICT,East Khasi Hills,Rural,459441,228409,231032
17,DISTRICT,East Khasi Hills,Urban,366481,182340,184141
17,DISTRICT,Jaintia Hills,Total,395124,196285,198839
17,DISTRICT,Jaintia Hills,Rural,366694,182610,184084
17,DISTRICT,Jaintia Hills,Urban,28430,13675,14755
18,STATE,ASSAM,Total,31205576,15939443,15266133
18,STATE,ASSAM,Rural,26807034,13678989,13128045
18,STATE,ASSAM,Urban,4398542,2260454,2138088
18,DISTRICT,Kokrajhar,Total,887142,452905,434237
18,DISTRICT,Kokrajhar,Rural,832201,424446,407755
18,DISTRICT,Kokrajhar,Urban,54941,28459,26482
18,DISTRICT,Dhubri,Total,1949258,997848,951410
18,DISTRICT,Dhubri,Rural,1745557,893914,851643
18,DISTRICT,Dhubri,Urban,203701,103934,99767
18,DISTRICT,Goalpara,Total,1008183,513292,494891
18,DISTRICT,Goalpara,Rural,870121,443244,426877
18,DISTRICT,Goalpara,Urban,138062,70048,68014
18,DISTRICT,Barpeta,Total,1693622,867004,826618
18,DISTRICT,Barpeta,Rural,1546269,791789,754480
18,DISTRICT,Barpeta,Urban,147353,75215,72138
18,DISTRICT,Morigaon,Total,957423,486651,470772
18,DISTRICT,Morigaon,Rural,884125,449123,435002
18,DISTRICT,Morigaon,Urban,73298,37528,35770
18,DISTRICT,Nagaon,Total,2823768,1439112,1384656
18,DISTRICT,Nagaon,Rural,2454234,1250985,1203249
18,DISTRICT,Nagaon,Urban,369534,188127,181407
18,DISTRICT,Sonitpur,Total,1924110,983904,940206
18,DISTRICT,Sonitpur,Rural,1750265,894985,855280
18,DISTRICT,Sonitpur,Urban,173845,88919,84926
18,DISTRICT,Lakhimpur,Total,1042137,529674,512463
18,DISTRICT,Lakhimpur,Rural,950804,482582,468222
18,DISTRICT,Lakhimpur,Urban,91333,47092,44241
18,DISTRICT,Dhemaji,Total,686133,351249,334884
18,DISTRICT,Dhemaji,Rural,637848,326278,311570
18,DISTRICT,Dhemaji,Urban,48285,24971,23314
18,DISTRICT,Tinsukia,Total,1327929,680231,647698
18,DISTRICT,Tinsukia,Rural,1063186,541395,521791
18,DISTRICT,Tinsukia,Urban,264743,138836,125907
18,DISTRICT,Dibrugarh,Total,1326335,676434,649901
18,DISTRICT,Dibrugarh,Rural,1082605,550299,532306
18,DISTRICT,Dibrugarh,Urban,243730,126135,117595
18,DISTRICT,Sivasagar,Total,1151050,589216,561834
18,DISTRICT,Sivasagar,Rural,1040954,531286,509668
18,DISTRICT,Sivasagar,Urban,110096,57930,52166
18,DISTRICT,Jorhat,Total,1092256,556805,535451
18,DISTRICT,Jorhat,Rural,871722,442968,428754
18,DISTRICT,Jorhat,Urban,220534,113837,106697
18,DISTRICT,Golaghat,Total,1066888,543161,523727
18,DISTRICT,Golaghat,Rural,969152,493125,476027
18,DISTRICT,Golaghat,Urban,97736,50036,47700
18,DISTRICT,Karbi Anglong,Total,956313,490167,466146
18,DISTRICT,Karbi Anglong,Rural,843347,431924,411423
18,DISTRICT,Karbi Anglong,Urban,112966,58243,54723
18,DISTRICT,Dima Hasao,Total,214102,110802,103300
18,DISTRICT,Dima Hasao,Rural,151613,77817,73796
18,DISTRICT,Dima Hasao,Urban,62489,32985,29504
18,DISTRICT,Cachar,Total,1736617,886284,850333
18,DISTRICT,Cachar,Rural,1421153,727083,694070
18,DISTRICT,Cachar,Urban,315464,159201,156263
18,DISTRICT,Karimganj,Total,1228686,625864,602822
18,DISTRICT,Karimganj,Rural,1118986,570510,548476
18,DISTRICT,Karimganj,Urban,109700,55354,54346
18,DISTRICT,Hailakandi,Total,659296,337890,321406
18,DISTRICT,Hailakandi,Rural,611156,313747,297409
18,DISTRICT,Hailakandi,Urban,48140,24143,23997
18,DISTRICT,Bongaigaon,Total,738804,375818,362986
18,DISTRICT,Bongaigaon,Rural,628994,319786,309208
18,DISTRICT,Bongaigaon,Urban,109810,56032,53778
18,DISTRICT,Chirang,Total,482162,244860,237302
18,DISTRICT,Chirang,Rural,446825,226895,219930
18,DISTRICT,Chirang,Urban,35337,17965,17372
18,DISTRICT,Kamrup,Total,1517542,778461,739081
18,DISTRICT,Kamrup,Rural,1375148,706140,669008
18,DISTRICT,Kamrup,Urban,142394,72321,70073
18,DISTRICT,Kamrup Metropolitan,Total,1253938,647585,606353
18,DISTRICT,Kamrup Metropolitan,Rural,216927,111062,105865
18,DISTRICT,Kamrup Metropolitan,Urban,1037011,536523,500488
18,DISTRICT,Nalbari,Total,771639,396006,375633
18,DISTRICT,Nalbari,Rural,688909,353677,335232
18,DISTRICT,Nalbari,Urban,82730,42329,40401
18,DISTRICT,Baksa,Total,950075,481330,468745
18,DISTRICT,Baksa,Rural,937833,475027,462806
18,DISTRICT,Baksa,Urban,12242,6303,5939
18,DISTRICT,Darrang,Total,928500,475273,453227
18,DISTRICT,Darrang,Rural,873006,446460,426546
18,DISTRICT,Darrang,Urban,55494,28813,26681
18,DISTRICT,Udalguri,Total,831668,421617,410051
18,DISTRICT,Udalguri,Rural,794094,402442,391652
18,DISTRICT,Udalguri,Urban,37574,19175,18399
19,STATE,WEST BENGAL,Total,91276115,46809027,44467088
19,STATE,WEST BENGAL,Rural,62183113,31844945,30338168
19,STATE,WEST BENGAL,Urban,29093002,14964082,14128920
19,DISTRICT,Darjiling ,Total,1846823,937259,909564
19,DISTRICT,Darjiling ,Rural,1118860,566965,551895
19,DISTRICT,Darjiling ,Urban,727963,370294,357669
19,DISTRICT,Jalpaiguri ,Total,3872846,1983064,1889782
19,DISTRICT,Jalpaiguri ,Rural,2812495,1437286,1375209
19,DISTRICT,Jalpaiguri ,Urban,1060351,545778,514573
19,DISTRICT,Koch Bihar ,Total,2819086,1451542,1367544
19,DISTRICT,Koch Bihar ,Rural,2529652,1304916,1224736
19,DISTRICT,Koch Bihar ,Urban,289434,146626,142808
19,DISTRICT,Uttar Dinajpur,Total,3007134,1551066,1456068
19,DISTRICT,Uttar Dinajpur,Rural,2644906,1362469,1282437
19,DISTRICT,Uttar Dinajpur,Urban,362228,188597,173631
19,DISTRICT,Dakshin Dinajpur,Total,1676276,857199,819077
19,DISTRICT,Dakshin Dinajpur,Rural,1439981,737771,702210
19,DISTRICT,Dakshin Dinajpur,Urban,236295,119428,116867
19,DISTRICT,Maldah ,Total,3988845,2051541,1937304
19,DISTRICT,Maldah ,Rural,3447185,1768336,1678849
19,DISTRICT,Maldah ,Urban,541660,283205,258455
19,DISTRICT,Murshidabad ,Total,7103807,3627564,3476243
19,DISTRICT,Murshidabad ,Rural,5703115,2917822,2785293
19,DISTRICT,Murshidabad ,Urban,1400692,709742,690950
19,DISTRICT,Birbhum,Total,3502404,1790920,1711484
19,DISTRICT,Birbhum,Rural,3052956,1561976,1490980
19,DISTRICT,Birbhum,Urban,449448,228944,220504
19,DISTRICT,Barddhaman ,Total,7717563,3966889,3750674
19,DISTRICT,Barddhaman ,Rural,4639264,2373787,2265477
19,DISTRICT,Barddhaman ,Urban,3078299,1593102,1485197
19,DISTRICT,Nadia ,Total,5167600,2653768,2513832
19,DISTRICT,Nadia ,Rural,3728727,1921112,1807615
19,DISTRICT,Nadia ,Urban,1438873,732656,706217
19,DISTRICT,North Twenty Four Parganas,Total,10009781,5119389,4890392
19,DISTRICT,North Twenty Four Parganas,Rural,4277619,2196554,2081065
19,DISTRICT,North Twenty Four Parganas,Urban,5732162,2922835,2809327
19,DISTRICT,Hugli ,Total,5519145,2814653,2704492
19,DISTRICT,Hugli ,Rural,3390646,1722945,1667701
19,DISTRICT,Hugli ,Urban,2128499,1091708,1036791
19,DISTRICT,Bankura ,Total,3596674,1838095,1758579
19,DISTRICT,Bankura ,Rural,3296901,1685777,1611124
19,DISTRICT,Bankura ,Urban,299773,152318,147455
19,DISTRICT,Puruliya,Total,2930115,1496996,1433119
19,DISTRICT,Puruliya,Rural,2556801,1304208,1252593
19,DISTRICT,Puruliya,Urban,373314,192788,180526
19,DISTRICT,Haora ,Total,4850029,2500819,2349210
19,DISTRICT,Haora ,Rural,1775885,909519,866366
19,DISTRICT,Haora ,Urban,3074144,1591300,1482844
19,DISTRICT,Kolkata,Total,4496694,2356766,2139928
19,DISTRICT,Kolkata,Rural,0,0,0
19,DISTRICT,Kolkata,Urban,4496694,2356766,2139928
19,DISTRICT,South Twenty Four Parganas,Total,8161961,4173778,3988183
19,DISTRICT,South Twenty Four Parganas,Rural,6074188,3109219,2964969
19,DISTRICT,South Twenty Four Parganas,Urban,2087773,1064559,1023214
19,DISTRICT,Paschim Medinipur,Total,5913457,3007885,2905572
19,DISTRICT,Paschim Medinipur,Rural,5190771,2641721,2549050
19,DISTRICT,Paschim Medinipur,Urban,722686,366164,356522
19,DISTRICT,Purba Medinipur,Total,5095875,2629834,2466041
19,DISTRICT,Purba Medinipur,Rural,4503161,2322562,2180599
19,DISTRICT,Purba Medinipur,Urban,592714,307272,285442
20,STATE,JHARKHAND,Total,32988134,16930315,16057819
20,STATE,JHARKHAND,Rural,25055073,12776486,12278587
20,STATE,JHARKHAND,Urban,7933061,4153829,3779232
20,DISTRICT,Garhwa ,Total,1322784,683575,639209
20,DISTRICT,Garhwa ,Rural,1253114,646947,606167
20,DISTRICT,Garhwa ,Urban,69670,36628,33042
20,DISTRICT,Chatra,Total,1042886,533935,508951
20,DISTRICT,Chatra,Rural,979932,500211,479721
20,DISTRICT,Chatra,Urban,62954,33724,29230
20,DISTRICT,Kodarma,Total,716259,367222,349037
20,DISTRICT,Kodarma,Rural,575013,293595,281418
20,DISTRICT,Kodarma,Urban,141246,73627,67619
20,DISTRICT,Giridih,Total,2445474,1258098,1187376
20,DISTRICT,Giridih,Rural,2237450,1149608,1087842
20,DISTRICT,Giridih,Urban,208024,108490,99534
20,DISTRICT,Deoghar,Total,1492073,775022,717051
20,DISTRICT,Deoghar,Rural,1233712,638136,595576
20,DISTRICT,Deoghar,Urban,258361,136886,121475
20,DISTRICT,Godda,Total,1313551,677927,635624
20,DISTRICT,Godda,Rural,1249132,643907,605225
20,DISTRICT,Godda,Urban,64419,34020,30399
20,DISTRICT,Sahibganj,Total,1150567,589391,561176
20,DISTRICT,Sahibganj,Rural,990901,505892,485009
20,DISTRICT,Sahibganj,Urban,159666,83499,76167
20,DISTRICT,Pakur,Total,900422,452661,447761
20,DISTRICT,Pakur,Rural,832910,418251,414659
20,DISTRICT,Pakur,Urban,67512,34410,33102
20,DISTRICT,Dhanbad,Total,2684487,1405956,1278531
20,DISTRICT,Dhanbad,Rural,1124093,581956,542137
20,DISTRICT,Dhanbad,Urban,1560394,824000,736394
20,DISTRICT,Bokaro,Total,2062330,1072807,989523
20,DISTRICT,Bokaro,Rural,1078686,554954,523732
20,DISTRICT,Bokaro,Urban,983644,517853,465791
20,DISTRICT,Lohardaga,Total,461790,232629,229161
20,DISTRICT,Lohardaga,Rural,404379,203255,201124
20,DISTRICT,Lohardaga,Urban,57411,29374,28037
20,DISTRICT,Purbi Singhbhum,Total,2293919,1176902,1117017
20,DISTRICT,Purbi Singhbhum,Rural,1019328,514498,504830
20,DISTRICT,Purbi Singhbhum,Urban,1274591,662404,612187
20,DISTRICT,Palamu,Total,1939869,1006302,933567
20,DISTRICT,Palamu,Rural,1713866,887551,826315
20,DISTRICT,Palamu,Urban,226003,118751,107252
20,DISTRICT,Latehar,Total,726978,369666,357312
20,DISTRICT,Latehar,Rural,675120,342566,332554
20,DISTRICT,Latehar,Urban,51858,27100,24758
20,DISTRICT,Hazaribagh,Total,1734495,890881,843614
20,DISTRICT,Hazaribagh,Rural,1459188,746934,712254
20,DISTRICT,Hazaribagh,Urban,275307,143947,131360
20,DISTRICT,Ramgarh,Total,949443,494230,455213
20,DISTRICT,Ramgarh,Rural,530488,272167,258321
20,DISTRICT,Ramgarh,Urban,418955,222063,196892
20,DISTRICT,Dumka,Total,1321442,668514,652928
20,DISTRICT,Dumka,Rural,1231264,620928,610336
20,DISTRICT,Dumka,Urban,90178,47586,42592
20,DISTRICT,Jamtara,Total,791042,404830,386212
20,DISTRICT,Jamtara,Rural,715296,365043,350253
20,DISTRICT,Jamtara,Urban,75746,39787,35959
20,DISTRICT,Ranchi,Total,2914253,1494937,1419316
20,DISTRICT,Ranchi,Rural,1656918,840528,816390
20,DISTRICT,Ranchi,Urban,1257335,654409,602926
20,DISTRICT,Khunti,Total,531885,266335,265550
20,DISTRICT,Khunti,Rural,486903,243494,243409
20,DISTRICT,Khunti,Urban,44982,22841,22141
20,DISTRICT,Gumla,Total,1025213,514390,510823
20,DISTRICT,Gumla,Rural,960132,481135,478997
20,DISTRICT,Gumla,Urban,65081,33255,31826
20,DISTRICT,Simdega,Total,599578,300309,299269
20,DISTRICT,Simdega,Rural,556634,278425,278209
20,DISTRICT,Simdega,Urban,42944,21884,21060
20,DISTRICT,Pashchimi Singhbhum,Total,1502338,749385,752953
20,DISTRICT,Pashchimi Singhbhum,Rural,1284304,637657,646647
20,DISTRICT,Pashchimi Singhbhum,Urban,218034,111728,106306
20,DISTRICT,Saraikela-Kharsawan,Total,1065056,544411,520645
20,DISTRICT,Saraikela-Kharsawan,Rural,806310,408848,397462
20,DISTRICT,Saraikela-Kharsawan,Urban,258746,135563,123183
21,STATE,ODISHA,Total,41974218,21212136,20762082
21,STATE,ODISHA,Rural,34970562,17586203,17384359
21,STATE,ODISHA,Urban,7003656,3625933,3377723
21,DISTRICT,Bargarh,Total,1481255,749161,732094
21,DISTRICT,Bargarh,Rural,1331145,672603,658542
21,DISTRICT,Bargarh,Urban,150110,76558,73552
21,DISTRICT,Jharsuguda,Total,579505,296690,282815
21,DISTRICT,Jharsuguda,Rural,348340,176162,172178
21,DISTRICT,Jharsuguda,Urban,231165,120528,110637
21,DISTRICT,Sambalpur,Total,1041099,526877,514222
21,DISTRICT,Sambalpur,Rural,733006,368692,364314
21,DISTRICT,Sambalpur,Urban,308093,158185,149908
21,DISTRICT,Debagarh,Total,312520,158230,154290
21,DISTRICT,Debagarh,Rural,290130,146666,143464
21,DISTRICT,Debagarh,Urban,22390,11564,10826
21,DISTRICT,Sundargarh,Total,2093437,1061147,1032290
21,DISTRICT,Sundargarh,Rural,1355340,676068,679272
21,DISTRICT,Sundargarh,Urban,738097,385079,353018
21,DISTRICT,Kendujhar,Total,1801733,906487,895246
21,DISTRICT,Kendujhar,Rural,1548674,774667,774007
21,DISTRICT,Kendujhar,Urban,253059,131820,121239
21,DISTRICT,Mayurbhanj,Total,2519738,1256213,1263525
21,DISTRICT,Mayurbhanj,Rural,2326842,1157576,1169266
21,DISTRICT,Mayurbhanj,Urban,192896,98637,94259
21,DISTRICT,Baleshwar,Total,2320529,1185787,1134742
21,DISTRICT,Baleshwar,Rural,2067236,1056466,1010770
21,DISTRICT,Baleshwar,Urban,253293,129321,123972
21,DISTRICT,Bhadrak,Total,1506337,760260,746077
21,DISTRICT,Bhadrak,Rural,1320499,665255,655244
21,DISTRICT,Bhadrak,Urban,185838,95005,90833
21,DISTRICT,Kendrapara ,Total,1440361,717814,722547
21,DISTRICT,Kendrapara ,Rural,1356827,675053,681774
21,DISTRICT,Kendrapara ,Urban,83534,42761,40773
21,DISTRICT,Jagatsinghapur ,Total,1136971,577865,559106
21,DISTRICT,Jagatsinghapur ,Rural,1020991,516813,504178
21,DISTRICT,Jagatsinghapur ,Urban,115980,61052,54928
21,DISTRICT,Cuttack,Total,2624470,1352760,1271710
21,DISTRICT,Cuttack,Rural,1888423,970885,917538
21,DISTRICT,Cuttack,Urban,736047,381875,354172
21,DISTRICT,Jajapur  ,Total,1827192,926034,901158
21,DISTRICT,Jajapur  ,Rural,1692095,856539,835556
21,DISTRICT,Jajapur  ,Urban,135097,69495,65602
21,DISTRICT,Dhenkanal,Total,1192811,612593,580218
21,DISTRICT,Dhenkanal,Rural,1075305,551326,523979
21,DISTRICT,Dhenkanal,Urban,117506,61267,56239
21,DISTRICT,Anugul  ,Total,1273821,655718,618103
21,DISTRICT,Anugul  ,Rural,1067275,546385,520890
21,DISTRICT,Anugul  ,Urban,206546,109333,97213
21,DISTRICT,Nayagarh  ,Total,962789,502636,460153
21,DISTRICT,Nayagarh  ,Rural,883051,461019,422032
21,DISTRICT,Nayagarh  ,Urban,79738,41617,38121
21,DISTRICT,Khordha ,Total,2251673,1167137,1084536
21,DISTRICT,Khordha ,Rural,1167357,595809,571548
21,DISTRICT,Khordha ,Urban,1084316,571328,512988
21,DISTRICT,Puri,Total,1698730,865380,833350
21,DISTRICT,Puri,Rural,1433800,728213,705587
21,DISTRICT,Puri,Urban,264930,137167,127763
21,DISTRICT,Ganjam,Total,3529031,1779218,1749813
21,DISTRICT,Ganjam,Rural,2761030,1383636,1377394
21,DISTRICT,Ganjam,Urban,768001,395582,372419
21,DISTRICT,Gajapati,Total,577817,282882,294935
21,DISTRICT,Gajapati,Rural,507151,247655,259496
21,DISTRICT,Gajapati,Urban,70666,35227,35439
21,DISTRICT,Kandhamal,Total,733110,359945,373165
21,DISTRICT,Kandhamal,Rural,660831,323523,337308
21,DISTRICT,Kandhamal,Urban,72279,36422,35857
21,DISTRICT,Baudh,Total,441162,221625,219537
21,DISTRICT,Baudh,Rural,420738,211133,209605
21,DISTRICT,Baudh,Urban,20424,10492,9932
21,DISTRICT,Subarnapur,Total,610183,311312,298871
21,DISTRICT,Subarnapur,Rural,560242,285634,274608
21,DISTRICT,Subarnapur,Urban,49941,25678,24263
21,DISTRICT,Balangir,Total,1648997,830097,818900
21,DISTRICT,Balangir,Rural,1451616,728770,722846
21,DISTRICT,Balangir,Urban,197381,101327,96054
21,DISTRICT,Nuapada,Total,610382,301962,308420
21,DISTRICT,Nuapada,Rural,576328,284792,291536
21,DISTRICT,Nuapada,Urban,34054,17170,16884
21,DISTRICT,Kalahandi,Total,1576869,787101,789768
21,DISTRICT,Kalahandi,Rural,1454882,724646,730236
21,DISTRICT,Kalahandi,Urban,121987,62455,59532
21,DISTRICT,Rayagada  ,Total,967911,471960,495951
21,DISTRICT,Rayagada  ,Rural,820945,397774,423171
21,DISTRICT,Rayagada  ,Urban,146966,74186,72780
21,DISTRICT,Nabarangapur ,Total,1220946,604812,616134
21,DISTRICT,Nabarangapur ,Rural,1133321,560771,572550
21,DISTRICT,Nabarangapur ,Urban,87625,44041,43584
21,DISTRICT,Koraput,Total,1379647,678809,700838
21,DISTRICT,Koraput,Rural,1153478,563771,589707
21,DISTRICT,Koraput,Urban,226169,115038,111131
21,DISTRICT,Malkangiri  ,Total,613192,303624,309568
21,DISTRICT,Malkangiri  ,Rural,563664,277901,285763
21,DISTRICT,Malkangiri  ,Urban,49528,25723,23805
22,STATE,CHHATTISGARH,Total,25545198,12832895,12712303
22,STATE,CHHATTISGARH,Rural,19607961,9797426,9810535
22,STATE,CHHATTISGARH,Urban,5937237,3035469,2901768
22,DISTRICT,Koriya,Total,658917,334737,324180
22,DISTRICT,Koriya,Rural,453618,228338,225280
22,DISTRICT,Koriya,Urban,205299,106399,98900
22,DISTRICT,Surguja,Total,2359886,1193129,1166757
22,DISTRICT,Surguja,Rural,2116965,1067908,1049057
22,DISTRICT,Surguja,Urban,242921,125221,117700
22,DISTRICT,Jashpur ,Total,851669,424747,426922
22,DISTRICT,Jashpur ,Rural,775677,386307,389370
22,DISTRICT,Jashpur ,Urban,75992,38440,37552
22,DISTRICT,Raigarh,Total,1493984,750278,743706
22,DISTRICT,Raigarh,Rural,1247682,623817,623865
22,DISTRICT,Raigarh,Urban,246302,126461,119841
22,DISTRICT,Korba ,Total,1206640,612915,593725
22,DISTRICT,Korba ,Rural,760350,381424,378926
22,DISTRICT,Korba ,Urban,446290,231491,214799
22,DISTRICT,Janjgir - Champa,Total,1619707,815717,803990
22,DISTRICT,Janjgir - Champa,Rural,1394646,701401,693245
22,DISTRICT,Janjgir - Champa,Urban,225061,114316,110745
22,DISTRICT,Bilaspur,Total,2663629,1351574,1312055
22,DISTRICT,Bilaspur,Rural,1983759,1002520,981239
22,DISTRICT,Bilaspur,Urban,679870,349054,330816
22,DISTRICT,Kabeerdham,Total,822526,412058,410468
22,DISTRICT,Kabeerdham,Rural,735131,367941,367190
22,DISTRICT,Kabeerdham,Urban,87395,44117,43278
22,DISTRICT,Rajnandgaon,Total,1537133,762855,774278
22,DISTRICT,Rajnandgaon,Rural,1264621,626212,638409
22,DISTRICT,Rajnandgaon,Urban,272512,136643,135869
22,DISTRICT,Durg,Total,3343872,1682101,1661771
22,DISTRICT,Durg,Rural,2059107,1026152,1032955
22,DISTRICT,Durg,Urban,1284765,655949,628816
22,DISTRICT,Raipur,Total,4063872,2048186,2015686
22,DISTRICT,Raipur,Rural,2580583,1288567,1292016
22,DISTRICT,Raipur,Urban,1483289,759619,723670
22,DISTRICT,Mahasamund,Total,1032754,511967,520787
22,DISTRICT,Mahasamund,Rural,912602,451691,460911
22,DISTRICT,Mahasamund,Urban,120152,60276,59876
22,DISTRICT,Dhamtari ,Total,799781,397897,401884
22,DISTRICT,Dhamtari ,Rural,650586,323420,327166
22,DISTRICT,Dhamtari ,Urban,149195,74477,74718
22,DISTRICT,Uttar Bastar Kanker,Total,748941,373338,375603
22,DISTRICT,Uttar Bastar Kanker,Rural,672180,335149,337031
22,DISTRICT,Uttar Bastar Kanker,Urban,76761,38189,38572
22,DISTRICT,Bastar,Total,1413199,698487,714712
22,DISTRICT,Bastar,Rural,1219705,600652,619053
22,DISTRICT,Bastar,Urban,193494,97835,95659
22,DISTRICT,Narayanpur,Total,139820,70104,69716
22,DISTRICT,Narayanpur,Rural,117714,58653,59061
22,DISTRICT,Narayanpur,Urban,22106,11451,10655
22,DISTRICT,Dakshin Bastar Dantewada,Total,533638,264142,269496
22,DISTRICT,Dakshin Bastar Dantewada,Rural,437405,213930,223475
22,DISTRICT,Dakshin Bastar Dantewada,Urban,96233,50212,46021
22,DISTRICT,Bijapur,Total,255230,128663,126567
22,DISTRICT,Bijapur,Rural,225630,113344,112286
22,DISTRICT,Bijapur,Urban,29600,15319,14281
23,STATE,MADHYA PRADESH,Total,72626809,37612306,35014503
23,STATE,MADHYA PRADESH,Rural,52557404,27149388,25408016
23,STATE,MADHYA PRADESH,Urban,20069405,10462918,9606487
23,DISTRICT,Sheopur ,Total,687861,361784,326077
23,DISTRICT,Sheopur ,Rural,580509,305360,275149
23,DISTRICT,Sheopur ,Urban,107352,56424,50928
23,DISTRICT,Morena,Total,1965970,1068417,897553
23,DISTRICT,Morena,Rural,1495508,815218,680290
23,DISTRICT,Morena,Urban,470462,253199,217263
23,DISTRICT,Bhind,Total,1703005,926843,776162
23,DISTRICT,Bhind,Rural,1270083,694756,575327
23,DISTRICT,Bhind,Urban,432922,232087,200835
23,DISTRICT,Gwalior,Total,2032036,1090327,941709
23,DISTRICT,Gwalior,Rural,758244,409349,348895
23,DISTRICT,Gwalior,Urban,1273792,680978,592814
23,DISTRICT,Datia,Total,786754,420157,366597
23,DISTRICT,Datia,Rural,604772,323966,280806
23,DISTRICT,Datia,Urban,181982,96191,85791
23,DISTRICT,Shivpuri,Total,1726050,919795,806255
23,DISTRICT,Shivpuri,Rural,1430627,763554,667073
23,DISTRICT,Shivpuri,Urban,295423,156241,139182
23,DISTRICT,Tikamgarh,Total,1445166,760355,684811
23,DISTRICT,Tikamgarh,Rural,1195293,629477,565816
23,DISTRICT,Tikamgarh,Urban,249873,130878,118995
23,DISTRICT,Chhatarpur,Total,1762375,936121,826254
23,DISTRICT,Chhatarpur,Rural,1363359,725273,638086
23,DISTRICT,Chhatarpur,Urban,399016,210848,188168
23,DISTRICT,Panna,Total,1016520,533480,483040
23,DISTRICT,Panna,Rural,891185,467473,423712
23,DISTRICT,Panna,Urban,125335,66007,59328
23,DISTRICT,Sagar,Total,2378458,1256257,1122201
23,DISTRICT,Sagar,Rural,1669662,884133,785529
23,DISTRICT,Sagar,Urban,708796,372124,336672
23,DISTRICT,Damoh,Total,1264219,661873,602346
23,DISTRICT,Damoh,Rural,1013668,530471,483197
23,DISTRICT,Damoh,Urban,250551,131402,119149
23,DISTRICT,Satna,Total,2228935,1157495,1071440
23,DISTRICT,Satna,Rural,1754517,907904,846613
23,DISTRICT,Satna,Urban,474418,249591,224827
23,DISTRICT,Rewa,Total,2365106,1225100,1140006
23,DISTRICT,Rewa,Rural,1969321,1017839,951482
23,DISTRICT,Rewa,Urban,395785,207261,188524
23,DISTRICT,Umaria,Total,644758,330674,314084
23,DISTRICT,Umaria,Rural,534214,273064,261150
23,DISTRICT,Umaria,Urban,110544,57610,52934
23,DISTRICT,Neemuch ,Total,826067,422653,403414
23,DISTRICT,Neemuch ,Rural,580837,295013,285824
23,DISTRICT,Neemuch ,Urban,245230,127640,117590
23,DISTRICT,Mandsaur,Total,1340411,682851,657560
23,DISTRICT,Mandsaur,Rural,1062807,540987,521820
23,DISTRICT,Mandsaur,Urban,277604,141864,135740
23,DISTRICT,Ratlam,Total,1455069,738241,716828
23,DISTRICT,Ratlam,Rural,1020038,516468,503570
23,DISTRICT,Ratlam,Urban,435031,221773,213258
23,DISTRICT,Ujjain,Total,1986864,1016289,970575
23,DISTRICT,Ujjain,Rural,1207651,616353,591298
23,DISTRICT,Ujjain,Urban,779213,399936,379277
23,DISTRICT,Shajapur,Total,1512681,780520,732161
23,DISTRICT,Shajapur,Rural,1219133,629273,589860
23,DISTRICT,Shajapur,Urban,293548,151247,142301
23,DISTRICT,Dewas,Total,1563715,805359,758356
23,DISTRICT,Dewas,Rural,1111956,571720,540236
23,DISTRICT,Dewas,Urban,451759,233639,218120
23,DISTRICT,Dhar,Total,2185793,1112725,1073068
23,DISTRICT,Dhar,Rural,1772572,895113,877459
23,DISTRICT,Dhar,Urban,413221,217612,195609
23,DISTRICT,Indore,Total,3276697,1699627,1577070
23,DISTRICT,Indore,Rural,848988,436755,412233
23,DISTRICT,Indore,Urban,2427709,1262872,1164837
23,DISTRICT,Khargone (West Nimar),Total,1873046,953121,919925
23,DISTRICT,Khargone (West Nimar),Rural,1574190,799396,774794
23,DISTRICT,Khargone (West Nimar),Urban,298856,153725,145131
23,DISTRICT,Barwani ,Total,1385881,699340,686541
23,DISTRICT,Barwani ,Rural,1181812,594907,586905
23,DISTRICT,Barwani ,Urban,204069,104433,99636
23,DISTRICT,Rajgarh,Total,1545814,790212,755602
23,DISTRICT,Rajgarh,Rural,1269357,648407,620950
23,DISTRICT,Rajgarh,Urban,276457,141805,134652
23,DISTRICT,Vidisha,Total,1458875,769568,689307
23,DISTRICT,Vidisha,Rural,1119257,591962,527295
23,DISTRICT,Vidisha,Urban,339618,177606,162012
23,DISTRICT,Bhopal,Total,2371061,1236130,1134931
23,DISTRICT,Bhopal,Rural,454010,238025,215985
23,DISTRICT,Bhopal,Urban,1917051,998105,918946
23,DISTRICT,Sehore,Total,1311332,683743,627589
23,DISTRICT,Sehore,Rural,1062870,554636,508234
23,DISTRICT,Sehore,Urban,248462,129107,119355
23,DISTRICT,Raisen,Total,1331597,700358,631239
23,DISTRICT,Raisen,Rural,1028172,539960,488212
23,DISTRICT,Raisen,Urban,303425,160398,143027
23,DISTRICT,Betul,Total,1575362,799236,776126
23,DISTRICT,Betul,Rural,1266211,640358,625853
23,DISTRICT,Betul,Urban,309151,158878,150273
23,DISTRICT,Harda ,Total,570465,294838,275627
23,DISTRICT,Harda ,Rural,451101,233312,217789
23,DISTRICT,Harda ,Urban,119364,61526,57838
23,DISTRICT,Hoshangabad,Total,1241350,648725,592625
23,DISTRICT,Hoshangabad,Rural,851364,445062,406302
23,DISTRICT,Hoshangabad,Urban,389986,203663,186323
23,DISTRICT,Katni ,Total,1292042,662013,630029
23,DISTRICT,Katni ,Rural,1028499,525188,503311
23,DISTRICT,Katni ,Urban,263543,136825,126718
23,DISTRICT,Jabalpur,Total,2463289,1277278,1186011
23,DISTRICT,Jabalpur,Rural,1023255,527031,496224
23,DISTRICT,Jabalpur,Urban,1440034,750247,689787
23,DISTRICT,Narsimhapur,Total,1091854,568810,523044
23,DISTRICT,Narsimhapur,Rural,888314,462699,425615
23,DISTRICT,Narsimhapur,Urban,203540,106111,97429
23,DISTRICT,Dindori ,Total,704524,351913,352611
23,DISTRICT,Dindori ,Rural,672206,335393,336813
23,DISTRICT,Dindori ,Urban,32318,16520,15798
23,DISTRICT,Mandla,Total,1054905,525272,529633
23,DISTRICT,Mandla,Rural,924716,459151,465565
23,DISTRICT,Mandla,Urban,130189,66121,64068
23,DISTRICT,Chhindwara,Total,2090922,1064468,1026454
23,DISTRICT,Chhindwara,Rural,1585739,806199,779540
23,DISTRICT,Chhindwara,Urban,505183,258269,246914
23,DISTRICT,Seoni,Total,1379131,695879,683252
23,DISTRICT,Seoni,Rural,1215241,612314,602927
23,DISTRICT,Seoni,Urban,163890,83565,80325
23,DISTRICT,Balaghat,Total,1701698,842178,859520
23,DISTRICT,Balaghat,Rural,1456882,719794,737088
23,DISTRICT,Balaghat,Urban,244816,122384,122432
23,DISTRICT,Guna,Total,1241519,649362,592157
23,DISTRICT,Guna,Rural,928844,486127,442717
23,DISTRICT,Guna,Urban,312675,163235,149440
23,DISTRICT,Ashoknagar,Total,845071,443837,401234
23,DISTRICT,Ashoknagar,Rural,691387,363411,327976
23,DISTRICT,Ashoknagar,Urban,153684,80426,73258
23,DISTRICT,Shahdol,Total,1066063,540021,526042
23,DISTRICT,Shahdol,Rural,846463,426583,419880
23,DISTRICT,Shahdol,Urban,219600,113438,106162
23,DISTRICT,Anuppur,Total,749237,379114,370123
23,DISTRICT,Anuppur,Rural,543996,272030,271966
23,DISTRICT,Anuppur,Urban,205241,107084,98157
23,DISTRICT,Sidhi,Total,1127033,575912,551121
23,DISTRICT,Sidhi,Rural,1033912,527378,506534
23,DISTRICT,Sidhi,Urban,93121,48534,44587
23,DISTRICT,Singrauli,Total,1178273,613637,564636
23,DISTRICT,Singrauli,Rural,951487,493324,458163
23,DISTRICT,Singrauli,Urban,226786,120313,106473
23,DISTRICT,Jhabua,Total,1025048,515023,510025
23,DISTRICT,Jhabua,Rural,933065,467468,465597
23,DISTRICT,Jhabua,Urban,91983,47555,44428
23,DISTRICT,Alirajpur,Total,728999,362542,366457
23,DISTRICT,Alirajpur,Rural,671925,333593,338332
23,DISTRICT,Alirajpur,Urban,57074,28949,28125
23,DISTRICT,Khandwa (East Nimar),Total,1310061,674329,635732
23,DISTRICT,Khandwa (East Nimar),Rural,1050625,541183,509442
23,DISTRICT,Khandwa (East Nimar),Urban,259436,133146,126290
23,DISTRICT,Burhanpur,Total,757847,388504,369343
23,DISTRICT,Burhanpur,Rural,497560,254978,242582
23,DISTRICT,Burhanpur,Urban,260287,133526,126761
24,STATE,GUJARAT,Total,60439692,31491260,28948432
24,STATE,GUJARAT,Rural,34694609,17799159,16895450
24,STATE,GUJARAT,Urban,25745083,13692101,12052982
24,DISTRICT,Kachchh,Total,2092371,1096737,995634
24,DISTRICT,Kachchh,Rural,1363836,713524,650312
24,DISTRICT,Kachchh,Urban,728535,383213,345322
24,DISTRICT,Banas Kantha,Total,3120506,1610379,1510127
24,DISTRICT,Banas Kantha,Rural,2705591,1393741,1311850
24,DISTRICT,Banas Kantha,Urban,414915,216638,198277
24,DISTRICT,Patan  ,Total,1343734,694397,649337
24,DISTRICT,Patan  ,Rural,1062653,548324,514329
24,DISTRICT,Patan  ,Urban,281081,146073,135008
24,DISTRICT,Mahesana,Total,2035064,1056520,978544
24,DISTRICT,Mahesana,Rural,1520734,787175,733559
24,DISTRICT,Mahesana,Urban,514330,269345,244985
24,DISTRICT,Sabar Kantha,Total,2428589,1244231,1184358
24,DISTRICT,Sabar Kantha,Rural,2064869,1056141,1008728
24,DISTRICT,Sabar Kantha,Urban,363720,188090,175630
24,DISTRICT,Gandhinagar,Total,1391753,723864,667889
24,DISTRICT,Gandhinagar,Rural,791126,408436,382690
24,DISTRICT,Gandhinagar,Urban,600627,315428,285199
24,DISTRICT,Ahmadabad,Total,7214225,3788051,3426174
24,DISTRICT,Ahmadabad,Rural,1151178,595583,555595
24,DISTRICT,Ahmadabad,Urban,6063047,3192468,2870579
24,DISTRICT,Surendranagar,Total,1756268,909917,846351
24,DISTRICT,Surendranagar,Rural,1259352,649475,609877
24,DISTRICT,Surendranagar,Urban,496916,260442,236474
24,DISTRICT,Rajkot,Total,3804558,1974445,1830113
24,DISTRICT,Rajkot,Rural,1590508,816264,774244
24,DISTRICT,Rajkot,Urban,2214050,1158181,1055869
24,DISTRICT,Jamnagar,Total,2160119,1114192,1045927
24,DISTRICT,Jamnagar,Rural,1189054,610088,578966
24,DISTRICT,Jamnagar,Urban,971065,504104,466961
24,DISTRICT,Porbandar ,Total,585449,300209,285240
24,DISTRICT,Porbandar ,Rural,299775,153260,146515
24,DISTRICT,Porbandar ,Urban,285674,146949,138725
24,DISTRICT,Junagadh,Total,2743082,1404356,1338726
24,DISTRICT,Junagadh,Rural,1836670,940271,896399
24,DISTRICT,Junagadh,Urban,906412,464085,442327
24,DISTRICT,Amreli,Total,1514190,771049,743141
24,DISTRICT,Amreli,Rural,1127555,572554,555001
24,DISTRICT,Amreli,Urban,386635,198495,188140
24,DISTRICT,Bhavnagar,Total,2880365,1490201,1390164
24,DISTRICT,Bhavnagar,Rural,1697964,868833,829131
24,DISTRICT,Bhavnagar,Urban,1182401,621368,561033
24,DISTRICT,Anand  ,Total,2092745,1087224,1005521
24,DISTRICT,Anand  ,Rural,1457758,758499,699259
24,DISTRICT,Anand  ,Urban,634987,328725,306262
24,DISTRICT,Kheda,Total,2299885,1185727,1114158
24,DISTRICT,Kheda,Rural,1776276,915197,861079
24,DISTRICT,Kheda,Urban,523609,270530,253079
24,DISTRICT,Panch Mahals,Total,2390776,1226961,1163815
24,DISTRICT,Panch Mahals,Rural,2055949,1053376,1002573
24,DISTRICT,Panch Mahals,Urban,334827,173585,161242
24,DISTRICT,Dohad  ,Total,2127086,1068651,1058435
24,DISTRICT,Dohad  ,Rural,1935461,970963,964498
24,DISTRICT,Dohad  ,Urban,191625,97688,93937
24,DISTRICT,Vadodara,Total,4165626,2153736,2011890
24,DISTRICT,Vadodara,Rural,2099855,1077943,1021912
24,DISTRICT,Vadodara,Urban,2065771,1075793,989978
24,DISTRICT,Narmada,Total,590297,301086,289211
24,DISTRICT,Narmada,Rural,528425,269408,259017
24,DISTRICT,Narmada,Urban,61872,31678,30194
24,DISTRICT,Bharuch,Total,1551019,805707,745312
24,DISTRICT,Bharuch,Rural,1026060,529393,496667
24,DISTRICT,Bharuch,Urban,524959,276314,248645
24,DISTRICT,The Dangs,Total,228291,113821,114470
24,DISTRICT,The Dangs,Rural,203604,101710,101894
24,DISTRICT,The Dangs,Urban,24687,12111,12576
24,DISTRICT,Navsari  ,Total,1329672,678165,651507
24,DISTRICT,Navsari  ,Rural,920535,464749,455786
24,DISTRICT,Navsari  ,Urban,409137,213416,195721
24,DISTRICT,Valsad,Total,1705678,887222,818456
24,DISTRICT,Valsad,Rural,1070177,542644,527533
24,DISTRICT,Valsad,Urban,635501,344578,290923
24,DISTRICT,Surat,Total,6081322,3402224,2679098
24,DISTRICT,Surat,Rural,1232109,640060,592049
24,DISTRICT,Surat,Urban,4849213,2762164,2087049
24,DISTRICT,Tapi,Total,807022,402188,404834
24,DISTRICT,Tapi,Rural,727535,361548,365987
24,DISTRICT,Tapi,Urban,79487,40640,38847
25,STATE,DAMAN & DIU,Total,243247,150301,92946
25,STATE,DAMAN & DIU,Rural,60396,32395,28001
25,STATE,DAMAN & DIU,Urban,182851,117906,64945
25,DISTRICT,Diu,Total,52074,25642,26432
25,DISTRICT,Diu,Rural,28083,14028,14055
25,DISTRICT,Diu,Urban,23991,11614,12377
25,DISTRICT,Daman,Total,191173,124659,66514
25,DISTRICT,Daman,Rural,32313,18367,13946
25,DISTRICT,Daman,Urban,158860,106292,52568
26,STATE,DADRA & NAGAR HAVELI,Total,343709,193760,149949
26,STATE,DADRA & NAGAR HAVELI,Rural,183114,98305,84809
26,STATE,DADRA & NAGAR HAVELI,Urban,160595,95455,65140
26,DISTRICT,Dadra & Nagar Haveli,Total,343709,193760,149949
26,DISTRICT,Dadra & Nagar Haveli,Rural,183114,98305,84809
26,DISTRICT,Dadra & Nagar Haveli,Urban,160595,95455,65140
27,STATE,MAHARASHTRA,Total,112374333,58243056,54131277
27,STATE,MAHARASHTRA,Rural,61556074,31539034,30017040
27,STATE,MAHARASHTRA,Urban,50818259,26704022,24114237
27,DISTRICT,Nandurbar,Total,1648295,833170,815125
27,DISTRICT,Nandurbar,Rural,1372821,687671,685150
27,DISTRICT,Nandurbar,Urban,275474,145499,129975
27,DISTRICT,Dhule,Total,2050862,1054031,996831
27,DISTRICT,Dhule,Rural,1479826,758916,720910
27,DISTRICT,Dhule,Urban,571036,295115,275921
27,DISTRICT,Jalgaon,Total,4229917,2197365,2032552
27,DISTRICT,Jalgaon,Rural,2887206,1500514,1386692
27,DISTRICT,Jalgaon,Urban,1342711,696851,645860
27,DISTRICT,Buldana,Total,2586258,1337560,1248698
27,DISTRICT,Buldana,Rural,2037398,1055242,982156
27,DISTRICT,Buldana,Urban,548860,282318,266542
27,DISTRICT,Akola,Total,1813906,932334,881572
27,DISTRICT,Akola,Rural,1094165,563933,530232
27,DISTRICT,Akola,Urban,719741,368401,351340
27,DISTRICT,Washim,Total,1197160,620302,576858
27,DISTRICT,Washim,Rural,985747,511727,474020
27,DISTRICT,Washim,Urban,211413,108575,102838
27,DISTRICT,Amravati,Total,2888445,1480768,1407677
27,DISTRICT,Amravati,Rural,1851158,950633,900525
27,DISTRICT,Amravati,Urban,1037287,530135,507152
27,DISTRICT,Wardha,Total,1300774,668385,632389
27,DISTRICT,Wardha,Rural,877474,451874,425600
27,DISTRICT,Wardha,Urban,423300,216511,206789
27,DISTRICT,Nagpur,Total,4653570,2384975,2268595
27,DISTRICT,Nagpur,Rural,1474811,758357,716454
27,DISTRICT,Nagpur,Urban,3178759,1626618,1552141
27,DISTRICT,Bhandara,Total,1200334,605520,594814
27,DISTRICT,Bhandara,Rural,966503,487484,479019
27,DISTRICT,Bhandara,Urban,233831,118036,115795
27,DISTRICT,Gondiya,Total,1322507,661554,660953
27,DISTRICT,Gondiya,Rural,1096577,547934,548643
27,DISTRICT,Gondiya,Urban,225930,113620,112310
27,DISTRICT,Gadchiroli,Total,1072942,541328,531614
27,DISTRICT,Gadchiroli,Rural,954909,481290,473619
27,DISTRICT,Gadchiroli,Urban,118033,60038,57995
27,DISTRICT,Chandrapur,Total,2204307,1123834,1080473
27,DISTRICT,Chandrapur,Rural,1428929,726106,702823
27,DISTRICT,Chandrapur,Urban,775378,397728,377650
27,DISTRICT,Yavatmal,Total,2772348,1419965,1352383
27,DISTRICT,Yavatmal,Rural,2174195,1115148,1059047
27,DISTRICT,Yavatmal,Urban,598153,304817,293336
27,DISTRICT,Nanded,Total,3361292,1730075,1631217
27,DISTRICT,Nanded,Rural,2447394,1258160,1189234
27,DISTRICT,Nanded,Urban,913898,471915,441983
27,DISTRICT,Hingoli,Total,1177345,606294,571051
27,DISTRICT,Hingoli,Rural,998612,514430,484182
27,DISTRICT,Hingoli,Urban,178733,91864,86869
27,DISTRICT,Parbhani,Total,1836086,942870,893216
27,DISTRICT,Parbhani,Rural,1266280,651886,614394
27,DISTRICT,Parbhani,Urban,569806,290984,278822
27,DISTRICT,Jalna,Total,1959046,1011473,947573
27,DISTRICT,Jalna,Rural,1581617,817279,764338
27,DISTRICT,Jalna,Urban,377429,194194,183235
27,DISTRICT,Aurangabad,Total,3701282,1924469,1776813
27,DISTRICT,Aurangabad,Rural,2081112,1081825,999287
27,DISTRICT,Aurangabad,Urban,1620170,842644,777526
27,DISTRICT,Nashik,Total,6107187,3157186,2950001
27,DISTRICT,Nashik,Rural,3509814,1804712,1705102
27,DISTRICT,Nashik,Urban,2597373,1352474,1244899
27,DISTRICT,Thane,Total,11060148,5865078,5195070
27,DISTRICT,Thane,Rural,2545470,1300136,1245334
27,DISTRICT,Thane,Urban,8514678,4564942,3949736
27,DISTRICT,Mumbai Suburban,Total,9356962,5031323,4325639
27,DISTRICT,Mumbai Suburban,Rural,0,0,0
27,DISTRICT,Mumbai Suburban,Urban,9356962,5031323,4325639
27,DISTRICT,Mumbai,Total,3085411,1684608,1400803
27,DISTRICT,Mumbai,Rural,0,0,0
27,DISTRICT,Mumbai,Urban,3085411,1684608,1400803
27,DISTRICT,Raigarh,Total,2634200,1344345,1289855
27,DISTRICT,Raigarh,Rural,1664005,836996,827009
27,DISTRICT,Raigarh,Urban,970195,507349,462846
27,DISTRICT,Pune,Total,9429408,4924105,4505303
27,DISTRICT,Pune,Rural,3678226,1903440,1774786
27,DISTRICT,Pune,Urban,5751182,3020665,2730517
27,DISTRICT,Ahmadnagar,Total,4543159,2342825,2200334
27,DISTRICT,Ahmadnagar,Rural,3630542,1872907,1757635
27,DISTRICT,Ahmadnagar,Urban,912617,469918,442699
27,DISTRICT,Bid,Total,2585049,1349106,1235943
27,DISTRICT,Bid,Rural,2070751,1082978,987773
27,DISTRICT,Bid,Urban,514298,266128,248170
27,DISTRICT,Latur,Total,2454196,1273140,1181056
27,DISTRICT,Latur,Rural,1829216,949707,879509
27,DISTRICT,Latur,Urban,624980,323433,301547
27,DISTRICT,Osmanabad,Total,1657576,861535,796041
27,DISTRICT,Osmanabad,Rural,1376519,716237,660282
27,DISTRICT,Osmanabad,Urban,281057,145298,135759
27,DISTRICT,Solapur,Total,4317756,2227852,2089904
27,DISTRICT,Solapur,Rural,2918665,1518343,1400322
27,DISTRICT,Solapur,Urban,1399091,709509,689582
27,DISTRICT,Satara,Total,3003741,1510842,1492899
27,DISTRICT,Satara,Rural,2433363,1219749,1213614
27,DISTRICT,Satara,Urban,570378,291093,279285
27,DISTRICT,Ratnagiri,Total,1615069,761121,853948
27,DISTRICT,Ratnagiri,Rural,1351346,630213,721133
27,DISTRICT,Ratnagiri,Urban,263723,130908,132815
27,DISTRICT,Sindhudurg,Total,849651,417332,432319
27,DISTRICT,Sindhudurg,Rural,742645,363268,379377
27,DISTRICT,Sindhudurg,Urban,107006,54064,52942
27,DISTRICT,Kolhapur,Total,3876001,1980658,1895343
27,DISTRICT,Kolhapur,Rural,2645992,1348815,1297177
27,DISTRICT,Kolhapur,Urban,1230009,631843,598166
27,DISTRICT,Sangli,Total,2822143,1435728,1386415
27,DISTRICT,Sangli,Rural,2102786,1071124,1031662
27,DISTRICT,Sangli,Urban,719357,364604,354753
28,STATE,ANDHRA PRADESH,Total,84580777,42442146,42138631
28,STATE,ANDHRA PRADESH,Rural,56361702,28243241,28118461
28,STATE,ANDHRA PRADESH,Urban,28219075,14198905,14020170
28,DISTRICT,Adilabad,Total,2741239,1369597,1371642
28,DISTRICT,Adilabad,Rural,1980980,985303,995677
28,DISTRICT,Adilabad,Urban,760259,384294,375965
28,DISTRICT,Nizamabad,Total,2551335,1250641,1300694
28,DISTRICT,Nizamabad,Rural,1962963,958837,1004126
28,DISTRICT,Nizamabad,Urban,588372,291804,296568
28,DISTRICT,Karimnagar,Total,3776269,1880800,1895469
28,DISTRICT,Karimnagar,Rural,2825044,1401950,1423094
28,DISTRICT,Karimnagar,Urban,951225,478850,472375
28,DISTRICT,Medak,Total,3033288,1523030,1510258
28,DISTRICT,Medak,Rural,2305417,1152806,1152611
28,DISTRICT,Medak,Urban,727871,370224,357647
28,DISTRICT,Hyderabad,Total,3943323,2018575,1924748
28,DISTRICT,Hyderabad,Rural,0,0,0
28,DISTRICT,Hyderabad,Urban,3943323,2018575,1924748
28,DISTRICT,Rangareddy,Total,5296741,2701008,2595733
28,DISTRICT,Rangareddy,Rural,1577569,801013,776556
28,DISTRICT,Rangareddy,Urban,3719172,1899995,1819177
28,DISTRICT,Mahbubnagar,Total,4053028,2050386,2002642
28,DISTRICT,Mahbubnagar,Rural,3445336,1742438,1702898
28,DISTRICT,Mahbubnagar,Urban,607692,307948,299744
28,DISTRICT,Nalgonda,Total,3488809,1759772,1729037
28,DISTRICT,Nalgonda,Rural,2826302,1427716,1398586
28,DISTRICT,Nalgonda,Urban,662507,332056,330451
28,DISTRICT,Warangal,Total,3512576,1759281,1753295
28,DISTRICT,Warangal,Rural,2520243,1260594,1259649
28,DISTRICT,Warangal,Urban,992333,498687,493646
28,DISTRICT,Khammam,Total,2797370,1390988,1406382
28,DISTRICT,Khammam,Rural,2141459,1066781,1074678
28,DISTRICT,Khammam,Urban,655911,324207,331704
28,DISTRICT,Srikakulam,Total,2703114,1341738,1361376
28,DISTRICT,Srikakulam,Rural,2266411,1126888,1139523
28,DISTRICT,Srikakulam,Urban,436703,214850,221853
28,DISTRICT,Vizianagaram,Total,2344474,1161477,1182997
28,DISTRICT,Vizianagaram,Rural,1853563,920428,933135
28,DISTRICT,Vizianagaram,Urban,490911,241049,249862
28,DISTRICT,Visakhapatnam,Total,4290589,2138910,2151679
28,DISTRICT,Visakhapatnam,Rural,2254667,1113234,1141433
28,DISTRICT,Visakhapatnam,Urban,2035922,1025676,1010246
28,DISTRICT,East Godavari,Total,5154296,2569688,2584608
28,DISTRICT,East Godavari,Rural,3840324,1922293,1918031
28,DISTRICT,East Godavari,Urban,1313972,647395,666577
28,DISTRICT,West Godavari,Total,3936966,1964918,1972048
28,DISTRICT,West Godavari,Rural,3128189,1567013,1561176
28,DISTRICT,West Godavari,Urban,808777,397905,410872
28,DISTRICT,Krishna,Total,4517398,2267375,2250023
28,DISTRICT,Krishna,Rural,2673738,1343534,1330204
28,DISTRICT,Krishna,Urban,1843660,923841,919819
28,DISTRICT,Guntur,Total,4887813,2440521,2447292
28,DISTRICT,Guntur,Rural,3235075,1621491,1613584
28,DISTRICT,Guntur,Urban,1652738,819030,833708
28,DISTRICT,Prakasam,Total,3397448,1714764,1682684
28,DISTRICT,Prakasam,Rural,2732866,1382641,1350225
28,DISTRICT,Prakasam,Urban,664582,332123,332459
28,DISTRICT,Sri Potti Sriramulu Nellore,Total,2963557,1492974,1470583
28,DISTRICT,Sri Potti Sriramulu Nellore,Rural,2105927,1060810,1045117
28,DISTRICT,Sri Potti Sriramulu Nellore,Urban,857630,432164,425466
28,DISTRICT,Y.S.R.,Total,2882469,1451777,1430692
28,DISTRICT,Y.S.R.,Rural,1903337,959693,943644
28,DISTRICT,Y.S.R.,Urban,979132,492084,487048
28,DISTRICT,Kurnool,Total,4053463,2039227,2014236
28,DISTRICT,Kurnool,Rural,2904177,1464569,1439608
28,DISTRICT,Kurnool,Urban,1149286,574658,574628
28,DISTRICT,Anantapur,Total,4081148,2064495,2016653
28,DISTRICT,Anantapur,Rural,2935437,1489157,1446280
28,DISTRICT,Anantapur,Urban,1145711,575338,570373
28,DISTRICT,Chittoor,Total,4174064,2090204,2083860
28,DISTRICT,Chittoor,Rural,2942678,1474052,1468626
28,DISTRICT,Chittoor,Urban,1231386,616152,615234
29,STATE,KARNATAKA,Total,61095297,30966657,30128640
29,STATE,KARNATAKA,Rural,37469335,18929354,18539981
29,STATE,KARNATAKA,Urban,23625962,12037303,11588659
29,DISTRICT,Belgaum,Total,4779661,2423063,2356598
29,DISTRICT,Belgaum,Rural,3568466,1811094,1757372
29,DISTRICT,Belgaum,Urban,1211195,611969,599226
29,DISTRICT,Bagalkot ,Total,1889752,950111,939641
29,DISTRICT,Bagalkot ,Rural,1291906,650267,641639
29,DISTRICT,Bagalkot ,Urban,597846,299844,298002
29,DISTRICT,Bijapur,Total,2177331,1111022,1066309
29,DISTRICT,Bijapur,Rural,1675353,857562,817791
29,DISTRICT,Bijapur,Urban,501978,253460,248518
29,DISTRICT,Bidar,Total,1703300,870665,832635
29,DISTRICT,Bidar,Rural,1277348,651250,626098
29,DISTRICT,Bidar,Urban,425952,219415,206537
29,DISTRICT,Raichur,Total,1928812,964511,964301
29,DISTRICT,Raichur,Rural,1438464,717972,720492
29,DISTRICT,Raichur,Urban,490348,246539,243809
29,DISTRICT,Koppal,Total,1389920,699926,689994
29,DISTRICT,Koppal,Rural,1156216,582958,573258
29,DISTRICT,Koppal,Urban,233704,116968,116736
29,DISTRICT,Gadag,Total,1064570,537147,527423
29,DISTRICT,Gadag,Rural,685261,347585,337676
29,DISTRICT,Gadag,Urban,379309,189562,189747
29,DISTRICT,Dharwad,Total,1847023,937206,909817
29,DISTRICT,Dharwad,Rural,797484,409416,388068
29,DISTRICT,Dharwad,Urban,1049539,527790,521749
29,DISTRICT,Uttara Kannada,Total,1437169,726256,710913
29,DISTRICT,Uttara Kannada,Rural,1018188,514910,503278
29,DISTRICT,Uttara Kannada,Urban,418981,211346,207635
29,DISTRICT,Haveri,Total,1597668,819128,778540
29,DISTRICT,Haveri,Rural,1242167,638450,603717
29,DISTRICT,Haveri,Urban,355501,180678,174823
29,DISTRICT,Bellary,Total,2452595,1236954,1215641
29,DISTRICT,Bellary,Rural,1532356,774093,758263
29,DISTRICT,Bellary,Urban,920239,462861,457378
29,DISTRICT,Chitradurga,Total,1659456,840843,818613
29,DISTRICT,Chitradurga,Rural,1329923,675573,654350
29,DISTRICT,Chitradurga,Urban,329533,165270,164263
29,DISTRICT,Davanagere,Total,1945497,986400,959097
29,DISTRICT,Davanagere,Rural,1316487,668267,648220
29,DISTRICT,Davanagere,Urban,629010,318133,310877
29,DISTRICT,Shimoga,Total,1752753,877415,875338
29,DISTRICT,Shimoga,Rural,1129026,565821,563205
29,DISTRICT,Shimoga,Urban,623727,311594,312133
29,DISTRICT,Udupi,Total,1177361,562131,615230
29,DISTRICT,Udupi,Rural,843300,398847,444453
29,DISTRICT,Udupi,Urban,334061,163284,170777
29,DISTRICT,Chikmagalur,Total,1137961,566622,571339
29,DISTRICT,Chikmagalur,Rural,898453,447545,450908
29,DISTRICT,Chikmagalur,Urban,239508,119077,120431
29,DISTRICT,Tumkur,Total,2678980,1350594,1328386
29,DISTRICT,Tumkur,Rural,2079902,1048710,1031192
29,DISTRICT,Tumkur,Urban,599078,301884,297194
29,DISTRICT,Bangalore,Total,9621551,5022661,4598890
29,DISTRICT,Bangalore,Rural,871607,464256,407351
29,DISTRICT,Bangalore,Urban,8749944,4558405,4191539
29,DISTRICT,Mandya,Total,1805769,905085,900684
29,DISTRICT,Mandya,Rural,1497407,751243,746164
29,DISTRICT,Mandya,Urban,308362,153842,154520
29,DISTRICT,Hassan,Total,1776421,883667,892754
29,DISTRICT,Hassan,Rural,1399658,695583,704075
29,DISTRICT,Hassan,Urban,376763,188084,188679
29,DISTRICT,Dakshina Kannada,Total,2089649,1034714,1054935
29,DISTRICT,Dakshina Kannada,Rural,1093563,541484,552079
29,DISTRICT,Dakshina Kannada,Urban,996086,493230,502856
29,DISTRICT,Kodagu,Total,554519,274608,279911
29,DISTRICT,Kodagu,Rural,473531,234161,239370
29,DISTRICT,Kodagu,Urban,80988,40447,40541
29,DISTRICT,Mysore,Total,3001127,1511600,1489527
29,DISTRICT,Mysore,Rural,1755714,887500,868214
29,DISTRICT,Mysore,Urban,1245413,624100,621313
29,DISTRICT,Chamarajanagar,Total,1020791,512231,508560
29,DISTRICT,Chamarajanagar,Rural,845817,424884,420933
29,DISTRICT,Chamarajanagar,Urban,174974,87347,87627
29,DISTRICT,Gulbarga,Total,2566326,1301755,1264571
29,DISTRICT,Gulbarga,Rural,1730775,877144,853631
29,DISTRICT,Gulbarga,Urban,835551,424611,410940
29,DISTRICT,Yadgir,Total,1174271,590329,583942
29,DISTRICT,Yadgir,Rural,953594,479078,474516
29,DISTRICT,Yadgir,Urban,220677,111251,109426
29,DISTRICT,Kolar,Total,1536401,776396,760005
29,DISTRICT,Kolar,Rural,1056328,535431,520897
29,DISTRICT,Kolar,Urban,480073,240965,239108
29,DISTRICT,Chikkaballapura,Total,1255104,636437,618667
29,DISTRICT,Chikkaballapura,Rural,973985,494463,479522
29,DISTRICT,Chikkaballapura,Urban,281119,141974,139145
29,DISTRICT,Bangalore Rural,Total,990923,509172,481751
29,DISTRICT,Bangalore Rural,Rural,722179,371369,350810
29,DISTRICT,Bangalore Rural,Urban,268744,137803,130941
29,DISTRICT,Ramanagara,Total,1082636,548008,534628
29,DISTRICT,Ramanagara,Rural,814877,412438,402439
29,DISTRICT,Ramanagara,Urban,267759,135570,132189
30,STATE,GOA,Total,1458545,739140,719405
30,STATE,GOA,Rural,551731,275436,276295
30,STATE,GOA,Urban,906814,463704,443110
30,DISTRICT,North Goa,Total,818008,416677,401331
30,DISTRICT,North Goa,Rural,324927,163908,161019
30,DISTRICT,North Goa,Urban,493081,252769,240312
30,DISTRICT,South Goa,Total,640537,322463,318074
30,DISTRICT,South Goa,Rural,226804,111528,115276
30,DISTRICT,South Goa,Urban,413733,210935,202798
31,STATE,LAKSHADWEEP,Total,64473,33123,31350
31,STATE,LAKSHADWEEP,Rural,14141,7243,6898
31,STATE,LAKSHADWEEP,Urban,50332,25880,24452
31,DISTRICT,Lakshadweep,Total,64473,33123,31350
31,DISTRICT,Lakshadweep,Rural,14141,7243,6898
31,DISTRICT,Lakshadweep,Urban,50332,25880,24452
32,STATE,KERALA,Total,33406061,16027412,17378649
32,STATE,KERALA,Rural,17471135,8408054,9063081
32,STATE,KERALA,Urban,15934926,7619358,8315568
32,DISTRICT,Kasaragod,Total,1307375,628613,678762
32,DISTRICT,Kasaragod,Rural,798328,387716,410612
32,DISTRICT,Kasaragod,Urban,509047,240897,268150
32,DISTRICT,Kannur,Total,2523003,1181446,1341557
32,DISTRICT,Kannur,Rural,882017,425682,456335
32,DISTRICT,Kannur,Urban,1640986,755764,885222
32,DISTRICT,Wayanad,Total,817420,401684,415736
32,DISTRICT,Wayanad,Rural,785840,386283,399557
32,DISTRICT,Wayanad,Urban,31580,15401,16179
32,DISTRICT,Kozhikode,Total,3086293,1470942,1615351
32,DISTRICT,Kozhikode,Rural,1013721,484784,528937
32,DISTRICT,Kozhikode,Urban,2072572,986158,1086414
32,DISTRICT,Malappuram,Total,4112920,1960328,2152592
32,DISTRICT,Malappuram,Rural,2295709,1095308,1200401
32,DISTRICT,Malappuram,Urban,1817211,865020,952191
32,DISTRICT,Palakkad,Total,2809934,1359478,1450456
32,DISTRICT,Palakkad,Rural,2133124,1031466,1101658
32,DISTRICT,Palakkad,Urban,676810,328012,348798
32,DISTRICT,Thrissur,Total,3121200,1480763,1640437
32,DISTRICT,Thrissur,Rural,1024794,488303,536491
32,DISTRICT,Thrissur,Urban,2096406,992460,1103946
32,DISTRICT,Ernakulam,Total,3282388,1619557,1662831
32,DISTRICT,Ernakulam,Rural,1048025,518510,529515
32,DISTRICT,Ernakulam,Urban,2234363,1101047,1133316
32,DISTRICT,Idukki ,Total,1108974,552808,556166
32,DISTRICT,Idukki ,Rural,1056929,527245,529684
32,DISTRICT,Idukki ,Urban,52045,25563,26482
32,DISTRICT,Kottayam,Total,1974551,968289,1006262
32,DISTRICT,Kottayam,Rural,1409158,692673,716485
32,DISTRICT,Kottayam,Urban,565393,275616,289777
32,DISTRICT,Alappuzha,Total,2127789,1013142,1114647
32,DISTRICT,Alappuzha,Rural,979643,464713,514930
32,DISTRICT,Alappuzha,Urban,1148146,548429,599717
32,DISTRICT,Pathanamthitta,Total,1197412,561716,635696
32,DISTRICT,Pathanamthitta,Rural,1065799,499820,565979
32,DISTRICT,Pathanamthitta,Urban,131613,61896,69717
32,DISTRICT,Kollam,Total,2635375,1246968,1388407
32,DISTRICT,Kollam,Rural,1448217,680687,767530
32,DISTRICT,Kollam,Urban,1187158,566281,620877
32,DISTRICT,Thiruvananthapuram,Total,3301427,1581678,1719749
32,DISTRICT,Thiruvananthapuram,Rural,1529831,724864,804967
32,DISTRICT,Thiruvananthapuram,Urban,1771596,856814,914782
33,STATE,TAMIL NADU,Total,72147030,36137975,36009055
33,STATE,TAMIL NADU,Rural,37229590,18679065,18550525
33,STATE,TAMIL NADU,Urban,34917440,17458910,17458530
33,DISTRICT,Thiruvallur,Total,3728104,1876062,1852042
33,DISTRICT,Thiruvallur,Rural,1299709,650462,649247
33,DISTRICT,Thiruvallur,Urban,2428395,1225600,1202795
33,DISTRICT,Chennai,Total,4646732,2335844,2310888
33,DISTRICT,Chennai,Rural,0,0,0
33,DISTRICT,Chennai,Urban,4646732,2335844,2310888
33,DISTRICT,Kancheepuram,Total,3998252,2012958,1985294
33,DISTRICT,Kancheepuram,Rural,1459916,734979,724937
33,DISTRICT,Kancheepuram,Urban,2538336,1277979,1260357
33,DISTRICT,Vellore,Total,3936331,1961688,1974643
33,DISTRICT,Vellore,Rural,2234344,1117101,1117243
33,DISTRICT,Vellore,Urban,1701987,844587,857400
33,DISTRICT,Tiruvannamalai,Total,2464875,1235889,1228986
33,DISTRICT,Tiruvannamalai,Rural,1969930,989726,980204
33,DISTRICT,Tiruvannamalai,Urban,494945,246163,248782
33,DISTRICT,Viluppuram,Total,3458873,1740819,1718054
33,DISTRICT,Viluppuram,Rural,2939785,1481475,1458310
33,DISTRICT,Viluppuram,Urban,519088,259344,259744
33,DISTRICT,Salem,Total,3482056,1781571,1700485
33,DISTRICT,Salem,Rural,1707934,883274,824660
33,DISTRICT,Salem,Urban,1774122,898297,875825
33,DISTRICT,Namakkal   ,Total,1726601,869280,857321
33,DISTRICT,Namakkal   ,Rural,1030476,520684,509792
33,DISTRICT,Namakkal   ,Urban,696125,348596,347529
33,DISTRICT,Erode,Total,2251744,1129868,1121876
33,DISTRICT,Erode,Rural,1093768,552393,541375
33,DISTRICT,Erode,Urban,1157976,577475,580501
33,DISTRICT,The Nilgiris,Total,735394,360143,375251
33,DISTRICT,The Nilgiris,Rural,299739,145909,153830
33,DISTRICT,The Nilgiris,Urban,435655,214234,221421
33,DISTRICT,Dindigul,Total,2159775,1080938,1078837
33,DISTRICT,Dindigul,Rural,1351735,678605,673130
33,DISTRICT,Dindigul,Urban,808040,402333,405707
33,DISTRICT,Karur ,Total,1064493,528184,536309
33,DISTRICT,Karur ,Rural,629976,312628,317348
33,DISTRICT,Karur ,Urban,434517,215556,218961
33,DISTRICT,Tiruchirappalli,Total,2722290,1352284,1370006
33,DISTRICT,Tiruchirappalli,Rural,1384257,688552,695705
33,DISTRICT,Tiruchirappalli,Urban,1338033,663732,674301
33,DISTRICT,Perambalur  ,Total,565223,282157,283066
33,DISTRICT,Perambalur  ,Rural,468060,233926,234134
33,DISTRICT,Perambalur  ,Urban,97163,48231,48932
33,DISTRICT,Ariyalur  ,Total,754894,374703,380191
33,DISTRICT,Ariyalur  ,Rural,671100,333253,337847
33,DISTRICT,Ariyalur  ,Urban,83794,41450,42344
33,DISTRICT,Cuddalore,Total,2605914,1311697,1294217
33,DISTRICT,Cuddalore,Rural,1720725,868861,851864
33,DISTRICT,Cuddalore,Urban,885189,442836,442353
33,DISTRICT,Nagapattinam  ,Total,1616450,798127,818323
33,DISTRICT,Nagapattinam  ,Rural,1251826,619369,632457
33,DISTRICT,Nagapattinam  ,Urban,364624,178758,185866
33,DISTRICT,Thiruvarur,Total,1264277,626693,637584
33,DISTRICT,Thiruvarur,Rural,1006482,499954,506528
33,DISTRICT,Thiruvarur,Urban,257795,126739,131056
33,DISTRICT,Thanjavur,Total,2405890,1182416,1223474
33,DISTRICT,Thanjavur,Rural,1554531,765177,789354
33,DISTRICT,Thanjavur,Urban,851359,417239,434120
33,DISTRICT,Pudukkottai,Total,1618345,803188,815157
33,DISTRICT,Pudukkottai,Rural,1301991,645505,656486
33,DISTRICT,Pudukkottai,Urban,316354,157683,158671
33,DISTRICT,Sivaganga,Total,1339101,668672,670429
33,DISTRICT,Sivaganga,Rural,926256,462210,464046
33,DISTRICT,Sivaganga,Urban,412845,206462,206383
33,DISTRICT,Madurai,Total,3038252,1526475,1511777
33,DISTRICT,Madurai,Rural,1191451,601247,590204
33,DISTRICT,Madurai,Urban,1846801,925228,921573
33,DISTRICT,Theni  ,Total,1245899,625683,620216
33,DISTRICT,Theni  ,Rural,575418,290880,284538
33,DISTRICT,Theni  ,Urban,670481,334803,335678
33,DISTRICT,Virudhunagar,Total,1942288,967709,974579
33,DISTRICT,Virudhunagar,Rural,962062,480360,481702
33,DISTRICT,Virudhunagar,Urban,980226,487349,492877
33,DISTRICT,Ramanathapuram,Total,1353445,682658,670787
33,DISTRICT,Ramanathapuram,Rural,942746,474508,468238
33,DISTRICT,Ramanathapuram,Urban,410699,208150,202549
33,DISTRICT,Thoothukkudi,Total,1750176,865021,885155
33,DISTRICT,Thoothukkudi,Rural,873374,430361,443013
33,DISTRICT,Thoothukkudi,Urban,876802,434660,442142
33,DISTRICT,Tirunelveli ,Total,3077233,1520912,1556321
33,DISTRICT,Tirunelveli ,Rural,1557004,768728,788276
33,DISTRICT,Tirunelveli ,Urban,1520229,752184,768045
33,DISTRICT,Kanniyakumari,Total,1870374,926345,944029
33,DISTRICT,Kanniyakumari,Rural,330572,164938,165634
33,DISTRICT,Kanniyakumari,Urban,1539802,761407,778395
33,DISTRICT,Dharmapuri,Total,1506843,774303,732540
33,DISTRICT,Dharmapuri,Rural,1245931,643215,602716
33,DISTRICT,Dharmapuri,Urban,260912,131088,129824
33,DISTRICT,Krishnagiri,Total,1879809,960232,919577
33,DISTRICT,Krishnagiri,Rural,1451446,742444,709002
33,DISTRICT,Krishnagiri,Urban,428363,217788,210575
33,DISTRICT,Coimbatore,Total,3458045,1729297,1728748
33,DISTRICT,Coimbatore,Rural,839105,419032,420073
33,DISTRICT,Coimbatore,Urban,2618940,1310265,1308675
33,DISTRICT,Tiruppur,Total,2479052,1246159,1232893
33,DISTRICT,Tiruppur,Rural,957941,479309,478632
33,DISTRICT,Tiruppur,Urban,1521111,766850,754261
34,STATE,PUDUCHERRY,Total,1247953,612511,635442
34,STATE,PUDUCHERRY,Rural,395200,194907,200293
34,STATE,PUDUCHERRY,Urban,852753,417604,435149
34,DISTRICT,Yanam,Total,55626,27301,28325
34,DISTRICT,Yanam,Rural,0,0,0
34,DISTRICT,Yanam,Urban,55626,27301,28325
34,DISTRICT,Puducherry,Total,950289,468258,482031
34,DISTRICT,Puducherry,Rural,293080,144769,148311
34,DISTRICT,Puducherry,Urban,657209,323489,333720
34,DISTRICT,Mahe,Total,41816,19143,22673
34,DISTRICT,Mahe,Rural,0,0,0
34,DISTRICT,Mahe,Urban,41816,19143,22673
34,DISTRICT,Karaikal,Total,200222,97809,102413
34,DISTRICT,Karaikal,Rural,102120,50138,51982
34,DISTRICT,Karaikal,Urban,98102,47671,50431
35,STATE,ANDAMAN & NICOBAR ISLANDS,Total,380581,202871,177710
35,STATE,ANDAMAN & NICOBAR ISLANDS,Rural,237093,126287,110806
35,STATE,ANDAMAN & NICOBAR ISLANDS,Urban,143488,76584,66904
35,DISTRICT,Nicobars,Total,36842,20727,16115
35,DISTRICT,Nicobars,Rural,36842,20727,16115
35,DISTRICT,Nicobars,Urban,0,0,0
35,DISTRICT,North  & Middle Andaman,Total,105597,54861,50736
35,DISTRICT,North  & Middle Andaman,Rural,102856,53457,49399
35,DISTRICT,North  & Middle Andaman,Urban,2741,1404,1337
35,DISTRICT,South Andaman,Total,238142,127283,110859
35,DISTRICT,South Andaman,Rural,97395,52103,45292
35,DISTRICT,South Andaman,Urban,140747,75180,65567
